Details,Posting Date,Description,Amount,Type,Balance,Check or Slip #
DEBIT,12/19/2017,POS DEBIT                UNICORN/NARWHAL           SEATTLE      WA,-6.5,MISC_DEBIT, ,
DEBIT,12/19/2017,POS DEBIT                UNICORN/NARWHAL           SEATTLE      WA,-20,MISC_DEBIT, ,
DEBIT,12/18/2017,PAYPAL           INST XFER  PARKMOBILE      WEB ID: PAYPALSI77,-2.25,ACH_DEBIT,1099.82,
DEBIT,12/18/2017,PAYPAL           INST XFER  XSOLLA          WEB ID: PAYPALSI77,-4.99,ACH_DEBIT,1102.07,
DEBIT,12/18/2017,FRED MEYE FRED MEYER 0 BELLINGHAM WA         12/16,-24.03,DEBIT_CARD,1107.06,
DEBIT,12/18/2017,THE ROYAL INN BELLINGHAM WA                  12/16,-9.5,DEBIT_CARD,1131.09,
DEBIT,12/18/2017,PEL MENI BELLINGHAM WA                       12/15,-17,DEBIT_CARD,1140.59,
DEBIT,12/18/2017,AUNTIE ANNES FERNDALE WA                     12/15,-6.51,DEBIT_CARD,1157.59,
DEBIT,12/18/2017,ARAMARK ZOES BOOKSIDE B BELLINGHAM WA        12/15,-5.82,DEBIT_CARD,1164.1,
DEBIT,12/18/2017,SECOND TIME AROUND COMP BELLINGHAM WA        12/13,-108.7,DEBIT_CARD,1169.92,
DEBIT,12/15/2017,GAMESTOP #4331 1 BELLI BELLINGHAM WA 621444  12/15,-14.12,DEBIT_CARD,1278.62,
DEBIT,12/14/2017,PAYPAL           INST XFER  PARKMOBILE      WEB ID: PAYPALSI77,-2.25,ACH_DEBIT,1292.74,
DEBIT,12/14/2017,ARAMARK VIKING UNION CA BELLINGHAM WA        12/12,-3.86,DEBIT_CARD,1294.99,
DEBIT,12/13/2017,PAYPAL           INST XFER  PARKMOBILE      WEB ID: PAYPALSI77,-8.25,ACH_DEBIT,1298.85,
DEBIT,12/13/2017,PAYPAL           INST XFER  FANDANGOMED     WEB ID: PAYPALSI77,-14.5,ACH_DEBIT,1307.1,
DEBIT,12/13/2017,FRED MEYE FRED MEYER 0 BELLINGHAM WA         12/13,-82.75,DEBIT_CARD,1321.6,
CREDIT,12/13/2017,"RAISER,LLC       EDI PAYMNT 34WMZPD2QEOEUX1 CCD ID: 1800896455",6.58,ACH_CREDIT,1404.35,
DEBIT,12/12/2017,WWU EMARKETS 360-650-3720 WA                 12/11,-22,DEBIT_CARD,1397.77,
DEBIT,12/12/2017,APL* ITUNES.COM/BILL 866-712-7753 CA         12/11,-16.29,DEBIT_CARD,1419.77,
DEBIT,12/12/2017,ARAMARK ZOES BOOKSIDE B BELLINGHAM WA        12/10,-12.87,DEBIT_CARD,1436.06,
CREDIT,12/12/2017,KEY CR. TRANSFER ONLINE-BK  017345595781024 WEB ID: 9000000008,1150,ACH_CREDIT,1448.93,
DSLIP,12/12/2017,REMOTE ONLINE DEPOSIT #          1,53.99,CHECK_DEPOSIT,298.93,1
DEBIT,12/11/2017,PAYPAL           INST XFER  XSOLLA          WEB ID: PAYPALSI77,-4.99,ACH_DEBIT,244.94,
DEBIT,12/11/2017,76 - STARVIN SAMS 14 BELLINGHAM WA           12/11,-46.09,DEBIT_CARD,249.93,
DEBIT,12/11/2017,DICK'S DRIVE-IN WALLING SEATTLE WA           12/10,-12.55,DEBIT_CARD,296.02,
DEBIT,12/11/2017,COMMUNITY FOOD CO-OP - BELLINGHAM WA 807936  12/09,-15.14,DEBIT_CARD,308.57,
DEBIT,12/11/2017,ARAMARK MILLER MARKET P BELLINGHAM WA        12/08,-5.68,DEBIT_CARD,323.71,
CREDIT,12/11/2017,VENMO            CASHOUT                    PPD ID: 5264681992,10,ACH_CREDIT,329.39,
DEBIT,12/8/2017,RITE AID STORE - 5238 BELLINGHAM WA  341188  12/08,-10,DEBIT_CARD,319.39,
DEBIT,12/7/2017,COMMUNITY FOOD CO-OP - BELLINGHAM WA 679935  12/07,-6.45,DEBIT_CARD,329.39,
DEBIT,12/6/2017,VENMO            PAYMENT    795883569       WEB ID: 3264681992,-17.03,ACH_DEBIT,335.84,
DEBIT,12/6/2017,TRANSFER TO SAV XXXXX9660 12/06,-25,ACCT_XFER,352.87,
DEBIT,12/6/2017,WWU EMARKETS 360-650-3720 WA                 12/05,-36,DEBIT_CARD,377.87,
DEBIT,12/5/2017,WWU EMARKETS 360-650-3720 WA                 12/04,-36,DEBIT_CARD,413.87,
DEBIT,12/4/2017,PAYPAL           INST XFER  PATREON         WEB ID: PAYPALSI77,-2,ACH_DEBIT,449.87,
DEBIT,12/4/2017,350.ORG 646-801-0759 NY                      12/01,-10,DEBIT_CARD,451.87,
DEBIT,12/4/2017,HAGGEN #3449 BELLINGHAM WA           215065  12/02,-23.33,DEBIT_CARD,461.87,
DEBIT,12/4/2017,76 - STARVIN SAMS 14 BELLINGHAM WA           12/01,-44.01,DEBIT_CARD,485.2,
DEBIT,12/1/2017,HAGGEN #3449 BELLINGHAM WA           866940  12/01,-30.53,DEBIT_CARD,529.21,
DEBIT,12/1/2017,HAGGEN #3449 BELLINGHAM WA           488646  12/01,-26.36,DEBIT_CARD,559.74,
DEBIT,12/1/2017,Online Transfer to  SAV ...9660 transaction#: 6633513773,-50,ACCT_XFER,586.1,
DEBIT,11/30/2017,PAYPAL           INST XFER  WIKIMEDIAFO     WEB ID: PAYPALSI77,-5,ACH_DEBIT,636.1,
DEBIT,11/30/2017,WWU PRINT AND COPY SERV BELLINGHAM WA        11/29,-35,DEBIT_CARD,641.1,
DEBIT,11/29/2017,FRED MEYE FRED MEYER 0 BELLINGHAM WA         11/29,-120.34,DEBIT_CARD,676.1,
DSLIP,11/29/2017,REMOTE ONLINE DEPOSIT #          1,12,CHECK_DEPOSIT,796.44,1
DEBIT,11/28/2017,VENMO            PAYMENT    782375982       WEB ID: 3264681992,-14.5,ACH_DEBIT,784.44,
CREDIT,11/28/2017,Square Inc       Squar      T20022795848    CCD ID: 8800429876,10,ACH_CREDIT,798.94,
DSLIP,11/28/2017,REMOTE ONLINE DEPOSIT #          1,47.99,CHECK_DEPOSIT,788.94,1
DEBIT,11/27/2017,PAYPAL           INST XFER  NEKOKIN         WEB ID: PAYPALSI77,-535,ACH_DEBIT,740.95,
DEBIT,11/27/2017,ZANE BURGERS BELLINGHAM WA                   11/26,-10.52,DEBIT_CARD,1275.95,
DEBIT,11/27/2017,SUNSET CAR WASH BELLINGHAM WA                11/25,-10,DEBIT_CARD,1286.47,
DEBIT,11/24/2017,ELSEVIER INC CHARGE 800-------- MO           11/24,-38.05,DEBIT_CARD,1296.47,
DEBIT,11/24/2017,76 - STARVIN SAMS 14 BELLINGHAM WA           11/22,-20.21,DEBIT_CARD,1334.52,
DEBIT,11/24/2017,ROOK AND ROGUE BOARD GA BELLINGHAM WA        11/21,-18.31,DEBIT_CARD,1354.73,
CREDIT,11/24/2017,KEY CR. TRANSFER ONLINE-BK  017326295062509 WEB ID: 9000000008,1150,ACH_CREDIT,1373.04,
DEBIT,11/22/2017,HAGGEN #3449 BELLINGHAM WA           886900  11/21,-14.82,DEBIT_CARD,223.04,
DEBIT,11/22/2017,ARAMARK VIKING UNION MA BELLINGHAM WA        11/20,-5.2,DEBIT_CARD,237.86,
DEBIT,11/22/2017,ARAMARK TOPIOS BELLINGHAM WA                 11/20,-7.91,DEBIT_CARD,243.06,
DEBIT,11/21/2017,FOREIGN EXCHANGE RATE ADJUSTMENT FEE         11/18SHELL 431,-1.7,FEE_TRANSACTION,250.97,
DEBIT,11/21/2017,SHELL 4314 WEST 10 AVEN VANCOUVER. BC        11/18 CA DOLLAR  72.34 X 0.7842134 (EXCHG RTE),-56.73,DEBIT_CARD,252.67,
CREDIT,11/21/2017,VENMO            CASHOUT                    PPD ID: 5264681992,20,ACH_CREDIT,309.4,
CREDIT,11/21/2017,PAYPAL           TRANSFER                   PPD ID: PAYPALSD11,52.01,ACH_CREDIT,289.4,
DEBIT,11/20/2017,RANCHO BRAVO TACOS SEATTLE WA                11/19,-10,DEBIT_CARD,237.39,
DEBIT,11/20/2017,FOREIGN EXCHANGE RATE ADJUSTMENT FEE         11/18MANCHESTE,-0.38,FEE_TRANSACTION,247.39,
DEBIT,11/20/2017,MANCHESTER PUBLIC HOUSE VANCOUVER BC         11/18 CA DOLLAR  16.14 X 0.7868649 (EXCHG RTE),-12.7,DEBIT_CARD,247.77,
DEBIT,11/20/2017,ARAMARK MILLER MARKET P BELLINGHAM WA        11/16,-6.95,DEBIT_CARD,260.47,
CREDIT,11/20/2017,VENMO            CASHOUT                    PPD ID: 5264681992,10,ACH_CREDIT,267.42,
CREDIT,11/20/2017,VENMO            CASHOUT                    PPD ID: 5264681992,68.5,ACH_CREDIT,257.42,
DEBIT,11/17/2017,ARAMARK MILLER MARKET P BELLINGHAM WA        11/15,-1.63,DEBIT_CARD,188.92,
DEBIT,11/17/2017,ARAMARK TONYS AT MILLER BELLINGHAM WA        11/15,-2.99,DEBIT_CARD,190.55,
DEBIT,11/16/2017,APL* ITUNES.COM/BILL 866-712-7753 CA         11/16,-6.5,DEBIT_CARD,193.54,
DEBIT,11/16/2017,SQ *BROTHA DUDES Bellingham WA               11/15,-11.78,DEBIT_CARD,200.04,
DEBIT,11/16/2017,BISTRO ATELIER DULLES DC                     11/14,-14.83,DEBIT_CARD,211.82,
DEBIT,11/16/2017,METRO 006-DUPONT CIRCLE WASHINGTON DC        11/14,-6.5,DEBIT_CARD,226.65,
DEBIT,11/15/2017,Blackfinn Ameripub - Wa Washington DC        11/13,-31.34,DEBIT_CARD,233.15,
DEBIT,11/15/2017,WASHINGTON DC CC REST 0 WASHINGTON DC        11/13,-9.75,DEBIT_CARD,264.49,
DEBIT,11/15/2017,WASHINGTON DC CC REST 0 WASHINGTON DC        11/12,-17.5,DEBIT_CARD,274.24,
DEBIT,11/14/2017,UBER   *TRIP 5ZJ6G 800-592-8996 CA           11/14,-10.75,DEBIT_CARD,291.74,
DEBIT,11/14/2017,UBER   *5ZRDW 800-592-8996 CA                11/14,-7.63,DEBIT_CARD,302.49,
DEBIT,11/14/2017,UBER   *6KUM7 800-592-8996 CA                11/14,-5,DEBIT_CARD,310.12,
DEBIT,11/14/2017,Kingfisher Washington DC                     11/13,-6.5,DEBIT_CARD,315.12,
DEBIT,11/14/2017,Kingfisher Washington DC                     11/12,-21.8,DEBIT_CARD,321.62,
DEBIT,11/14/2017,RENAISSANCE DC DNTWN 866-435-7627 DC         11/12,-26.1,DEBIT_CARD,343.42,
DEBIT,11/13/2017,NON-CHASE ATM FEE-WITH,-2.5,FEE_TRANSACTION,369.52,
DEBIT,11/13/2017,NON-CHASE ATM WITHDRAW               465616  11/13655 K ST,-23,ATM,372.02,
DEBIT,11/13/2017,UBER   *TRIP QWMMH 800-592-8996 CA           11/13,-10.24,DEBIT_CARD,395.02,
DEBIT,11/13/2017,UBER   *TRIP IVOAL 800-592-8996 CA           11/13,-7.31,DEBIT_CARD,405.26,
DEBIT,11/13/2017,FARE WELL WASHINGTON DC                      11/12,-42,DEBIT_CARD,412.57,
DEBIT,11/13/2017,BABY WALE WASHINGTON DC                      11/11,-15.1,DEBIT_CARD,454.57,
DEBIT,11/13/2017,APL* ITUNES.COM/BILL 866-712-7753 CA         11/11,-24.97,DEBIT_CARD,469.67,
DEBIT,11/13/2017,CHIPOTLE 1579 WASHINGTON DC                  11/11,-9,DEBIT_CARD,494.64,
DEBIT,11/13/2017,SAFEWAY STORE     2737 WASHINGTON DC 739967  11/11,-6.1,DEBIT_CARD,503.64,
DEBIT,11/13/2017,UBER   *TRIP N63KW 800-592-8996 CA           11/11,-7.88,DEBIT_CARD,509.74,
DEBIT,11/13/2017,UBER   *TRIP LWT2M 800-592-8996 CA           11/11,-7.92,DEBIT_CARD,517.62,
DEBIT,11/13/2017,THE CODMOTHER WASHINGTON DC                  11/10,-29.4,DEBIT_CARD,525.54,
DEBIT,11/13/2017,UBER   *ZWO6E 800-592-8996 CA                11/11,-8.16,DEBIT_CARD,554.94,
DEBIT,11/13/2017,UBER   *TRIP 62DCR 800-592-8996 CA           11/11,-7.98,DEBIT_CARD,563.1,
DEBIT,11/13/2017,BURGER KING #2510 MOUNT VERNON WA            11/09,-9.22,DEBIT_CARD,571.08,
DEBIT,11/10/2017,UBER   *TRIP TPCAT 800-592-8996 CA           11/10,-8.38,DEBIT_CARD,580.3,
DEBIT,11/10/2017,DULLES WASHINGTON FLYER CLIFTON VA           11/09,-5,DEBIT_CARD,588.68,
DEBIT,11/10/2017,CHEVRON 0211635 BELLINGHAM WA                11/09,-42.81,DEBIT_CARD,593.68,
DEBIT,11/10/2017,SQ *LAKEWAY CHEVRON & D Bellingham WA        11/09,-1.99,DEBIT_CARD,636.49,
CREDIT,11/10/2017,QuickPay with Zelle payment from SUSAN K LOFTUS 6660309315,100,QUICKPAY_CREDIT,638.48,
DEBIT,11/9/2017,ERM11835  1862 Wiehle RESTON VA              11/09,-10,DEBIT_CARD,538.48,
DEBIT,11/9/2017,USCONNECT ADVGV VEND N FERNDALE WA           11/09,-1.25,DEBIT_CARD,548.48,
DEBIT,11/9/2017,USCONNECT ADVGV VEND N FERNDALE WA           11/09,-1.25,DEBIT_CARD,549.73,
DEBIT,11/8/2017,CASA QUE PASA BELLINGHAM WA                  11/05,-23.07,DEBIT_CARD,550.98,
DEBIT,11/6/2017,TRANSFER TO SAV XXXXX9660 11/06,-25,ACCT_XFER,574.05,
DEBIT,11/6/2017,HAGGEN #3449 BELLINGHAM WA           834965  11/05,-31.15,DEBIT_CARD,599.05,
DEBIT,11/6/2017,ROOK AND ROGUE BOARD GA BELLINGHAM WA        11/05,-17.42,DEBIT_CARD,630.2,
DEBIT,11/6/2017,HAGGEN #3449 BELLINGHAM WA           241276  11/04,-22.39,DEBIT_CARD,647.62,
DEBIT,11/3/2017,WWU EMARKETS 360-650-3720 WA                 11/02,-36,DEBIT_CARD,670.01,
DEBIT,11/2/2017,350.ORG 646-801-0759 NY                      11/01,-10,DEBIT_CARD,706.01,
DSLIP,11/2/2017,REMOTE ONLINE DEPOSIT #          1,106.68,CHECK_DEPOSIT,716.01,1
DEBIT,11/1/2017,Online Transfer to  SAV ...9660 transaction#: 6552858233,-50,ACCT_XFER,609.33,
DEBIT,10/30/2017,HAGGEN #3449 BELLINGHAM WA           944242  10/28,-11.28,DEBIT_CARD,659.33,
DEBIT,10/30/2017,SAFEWAY  FUEL   1472 MOUNT VERNON WA 732981  10/28,-37.91,DEBIT_CARD,670.61,
DEBIT,10/26/2017,WITHDRAWAL 10/26,-535,MISC_DEBIT,708.52,
DEBIT,10/26/2017,FRED MEYE FRED MEYER 6 BELLINGHAM WA         10/26,-60.92,DEBIT_CARD,1243.52,
CREDIT,10/25/2017,"RAISER,LLC       EDI PAYMNT FR4VGEDUDQH6Z3F CCD ID: 1800896455",20.22,ACH_CREDIT,1304.44,
CREDIT,10/24/2017,KEY CR. TRANSFER ONLINE-BK  017296745107443 WEB ID: 9000000008,1150,ACH_CREDIT,1284.22,
DEBIT,10/18/2017,UNITED      016292149 800-932-2732 TX        10/17,-75,DEBIT_CARD,134.22,
CREDIT,10/18/2017,Lyft.com         TRANSFER   Lyft 10-17 Wkly CCD ID: 1800948598,4.28,ACH_CREDIT,209.22,
CREDIT,10/18/2017,"RAISER,LLC       EDI PAYMNT 382666097       CCD ID: 1800896455",11.28,ACH_CREDIT,204.94,
DEBIT,10/17/2017,WWU EMARKETS 360-650-3720 WA                 10/16,-36,DEBIT_CARD,193.66,
CREDIT,10/17/2017,Online Transfer from SAV ...9660 transaction#: 6599771908,75,ACCT_XFER,229.66,
DEBIT,10/16/2017,TARGET T- 30 Bellis Fa Bellingham WA         10/15,-27.16,DEBIT_CARD,154.66,
DEBIT,10/16/2017,ARAMARK ZOES BOOKSIDE B BELLINGHAM WA        10/14,-2.37,DEBIT_CARD,181.82,
DEBIT,10/16/2017,TRADER JOE'S # 151 BELLINGHAM WA     213983  10/14,-69.6,DEBIT_CARD,184.19,
DEBIT,10/16/2017,ARAMARK ZOES BOOKSIDE B BELLINGHAM WA        10/13,-7.7,DEBIT_CARD,253.79,
DEBIT,10/16/2017,ARAMARK TONYS AT MILLER BELLINGHAM WA        10/12,-3.86,DEBIT_CARD,261.49,
DEBIT,10/16/2017,ARAMARK MILLER MARKET P BELLINGHAM WA        10/12,-9.22,DEBIT_CARD,265.35,
DEBIT,10/13/2017,USCONNECT ADVGV VEND N FERNDALE WA           10/13,-1.75,DEBIT_CARD,274.57,
DEBIT,10/13/2017,USCONNECT ADVGV VEND N FERNDALE WA           10/13,-1.25,DEBIT_CARD,276.32,
DEBIT,10/13/2017,ARAMARK TONYS AT MILLER BELLINGHAM WA        10/11,-3.64,DEBIT_CARD,277.57,
DEBIT,10/12/2017,USCONNECT ADVGV VEND N FERNDALE WA           10/12,-1.25,DEBIT_CARD,281.21,
DEBIT,10/12/2017,USCONNECT ADVGV VEND N FERNDALE WA           10/12,-1.25,DEBIT_CARD,282.46,
DEBIT,10/12/2017,SQ *INDIA GRILL Bellingham WA                10/11,-8.15,DEBIT_CARD,283.71,
DEBIT,10/12/2017,ARAMARK MILLER MARKET P BELLINGHAM WA        10/10,-7.38,DEBIT_CARD,291.86,
DEBIT,10/11/2017,HAGGEN #3449 BELLINGHAM WA           933158  10/10,-15.99,DEBIT_CARD,299.24,
DEBIT,10/11/2017,ARAMARK MILLER MARKET P BELLINGHAM WA        10/09,-6.95,DEBIT_CARD,315.23,
DEBIT,10/10/2017,FRED MEYER 1225 W BAKE BELLINGHAM WA 722660  10/09,-37.44,DEBIT_CARD,322.18,
DEBIT,10/10/2017,WENDYS 9659 BELLINGHAM WA                    10/08,-8.24,DEBIT_CARD,359.62,
DEBIT,10/10/2017,RITE AID STORE - 5238 BELLINGHAM WA  569012  10/08,-54.34,DEBIT_CARD,367.86,
DEBIT,10/10/2017,ARAMARK TONYS AT MILLER BELLINGHAM WA        10/06,-6.9,DEBIT_CARD,422.2,
DEBIT,10/6/2017,TRANSFER TO SAV XXXXX9660 10/06,-25,ACCT_XFER,429.1,
DEBIT,10/6/2017,ARAMARK TONYS AT MILLER BELLINGHAM WA        10/04,-3.64,DEBIT_CARD,454.1,
DEBIT,10/5/2017,PIZZA TIME BELLINGHAM WA                     10/03,-12.45,DEBIT_CARD,457.74,
DEBIT,10/4/2017,PAYPAL           INST XFER  PARKMOBILE      WEB ID: PAYPALSI77,-2.25,ACH_DEBIT,470.19,
DEBIT,10/4/2017,PAYPAL           INST XFER  PARKMOBILE      WEB ID: PAYPALSI77,-4.25,ACH_DEBIT,472.44,
DEBIT,10/4/2017,SOC FOR NEUROSCIENCE 202-962-4000 DC         10/03,-280,DEBIT_CARD,476.69,
DEBIT,10/4/2017,ARAMARK STARBUCKS BELLINGHAM WA              10/02,-4.27,DEBIT_CARD,756.69,
CREDIT,10/4/2017,"RAISER,LLC       EDI PAYMNT 370094409       CCD ID: 1800896455",6.55,ACH_CREDIT,760.96,
DEBIT,10/3/2017,PAYPAL           INST XFER  PARKMOBILE      WEB ID: PAYPALSI77,-4.25,ACH_DEBIT,754.41,
DEBIT,10/2/2017,PAYPAL           INST XFER  PATREON         WEB ID: PAYPALSI77,-2,ACH_DEBIT,758.66,
DEBIT,10/2/2017,350.ORG 646-801-0759 NY                      10/01,-10,DEBIT_CARD,760.66,
DEBIT,9/29/2017,NON-CHASE ATM FEE-WITH,-2.5,FEE_TRANSACTION,770.66,
DEBIT,9/29/2017,HAGGEN #3439 BELLINGHAM WA           887155  09/29,-62.6,DEBIT_CARD,773.16,
DEBIT,9/29/2017,Online Transfer to  SAV ...9660 transaction#: 6485382752,-50,ACCT_XFER,835.76,
DEBIT,9/29/2017,NON-CHASE ATM WITHDRAW               033546  09/281100 N. S,-27,ATM,885.76,
DEBIT,9/28/2017,ARAMARK TONYS AT MILLER BELLINGHAM WA        09/26,-4.95,DEBIT_CARD,912.76,
DEBIT,9/27/2017,PHO 99 BELLINGHAM BELLINGHAM WA              09/27,-26.94,DEBIT_CARD,917.71,
DEBIT,9/27/2017,PEL MENI BELLINGHAM WA                       09/25,-9.2,DEBIT_CARD,944.65,
DEBIT,9/27/2017,ARAMARK TONYS AT MILLER BELLINGHAM WA        09/25,-5.82,DEBIT_CARD,953.85,
CREDIT,9/27/2017,"RAISER,LLC       EDI PAYMNT 363771909       CCD ID: 1800896455",6.03,ACH_CREDIT,959.67,
DEBIT,9/25/2017,PAYPAL           INST XFER  NEKOKIN         WEB ID: PAYPALSI77,-535,ACH_DEBIT,953.64,
DEBIT,9/25/2017,SHELL Service Station SEATTLE WA     033281  09/24,-40.64,DEBIT_CARD,1488.64,
DEBIT,9/25/2017,SHELL Service Station SEATTLE WA     233122  09/24,-3.88,DEBIT_CARD,1529.28,
DEBIT,9/25/2017,SQ *SEATTLE FUSION SEATTLE WA                09/23,-6,DEBIT_CARD,1533.16,
DEBIT,9/25/2017,ROXYS DELI SEATTLE WA                        09/23,-11.96,DEBIT_CARD,1539.16,
DEBIT,9/25/2017,TACO TIME BELLINGHAM-SA BELLINGHAM WA        09/23,-10.19,DEBIT_CARD,1551.12,
DEBIT,9/25/2017,THRESHOLD DOCUMENTS BELLINGHAM WA            09/22,-26.09,DEBIT_CARD,1561.31,
DEBIT,9/22/2017,PAYPAL           INST XFER  NEKOKIN         WEB ID: PAYPALSI77,-16.66,ACH_DEBIT,1587.4,
DEBIT,9/22/2017,SUPER DUPER BURGER & T BELLINGHAM WA         09/22,-11.64,DEBIT_CARD,1604.06,
DEBIT,9/21/2017,CITY OF BELLINGHAM PARK BELLINGHAM WA        09/20,-1.75,DEBIT_CARD,1615.7,
DEBIT,9/21/2017,CITY OF BELLINGHAM PARK BELLINGHAM WA        09/20,-0.5,DEBIT_CARD,1617.45,
DEBIT,9/21/2017,GREEN FROG BELLINGHAM WA                     09/20,-8.05,DEBIT_CARD,1617.95,
DEBIT,9/20/2017,PAYPAL           INST XFER  PARKMOBILE      WEB ID: PAYPALSI77,-3.25,ACH_DEBIT,1626,
DEBIT,9/20/2017,USCONNECT ADVGV VEND N FERNDALE WA           09/20,-1.75,DEBIT_CARD,1629.25,
DEBIT,9/20/2017,USCONNECT ADVGV VEND N FERNDALE WA           09/20,-1.25,DEBIT_CARD,1631,
DEBIT,9/20/2017,STARBUCKS STORE 03290 BELLINGHAM WA          09/18,-10.76,DEBIT_CARD,1632.25,
CREDIT,9/20/2017,KEY CR. TRANSFER ONLINE-BK  017262172295647 WEB ID: 9000000008,775,ACH_CREDIT,1643.01,
DEBIT,9/19/2017,BOOMERS DRIVE IN BELLINGHAM WA               09/17,-10.12,DEBIT_CARD,868.01,
CREDIT,9/19/2017,KEY CR. TRANSFER ONLINE-BK  017261156465208 WEB ID: 9000000008,375,ACH_CREDIT,878.13,
CREDIT,9/19/2017,KEY CR. TRANSFER ONLINE-BK  017261156392678 WEB ID: 9000000008,375,ACH_CREDIT,503.13,
DEBIT,9/18/2017,PAYPAL           INST XFER  XSOLLA          WEB ID: PAYPALSI77,-4.99,ACH_DEBIT,128.13,
DEBIT,9/18/2017,PAYPAL           INST XFER  NEKOKIN         WEB ID: PAYPALSI77,-27,ACH_DEBIT,133.12,
DEBIT,9/18/2017,VENMO            PAYMENT    678564632       WEB ID: 3264681992,-270,ACH_DEBIT,160.12,
DEBIT,9/18/2017,FRED MEYE FRED MEYER 0 SHORELINE WA          09/18,-21.99,DEBIT_CARD,430.12,
DEBIT,9/18/2017,SHELL Service Station SEATTLE WA     046742  09/18,-48.18,DEBIT_CARD,452.11,
DEBIT,9/18/2017,ATM WITHDRAWAL                       003537  09/16359 STRAN,-40,ATM,500.29,
CREDIT,9/18/2017,Online Transfer from SAV ...9660 transaction#: 6525428695,270,ACCT_XFER,540.29,
DEBIT,9/15/2017,SHELL Service Station LYNNWOOD WA    004726  09/15,-45.89,DEBIT_CARD,270.29,
DEBIT,9/14/2017,PAYPAL           INST XFER  KIGOSAI         WEB ID: PAYPALSI77,-10,ACH_DEBIT,316.18,
DEBIT,9/14/2017,HAGGEN #3449 BELLINGHAM WA           474956  09/13,-19.17,DEBIT_CARD,326.18,
CREDIT,9/14/2017,KEY CR. TRANSFER ONLINE-BK  017256074383884 WEB ID: 9000000008,296.54,ACH_CREDIT,345.35,
DEBIT,9/13/2017,PAYPAL           INST XFER  NEKOKIN         WEB ID: PAYPALSI77,-16,ACH_DEBIT,48.81,
DEBIT,9/13/2017,FRED MEYE FRED MEYER 0 BELLINGHAM WA         09/13,-70.67,DEBIT_CARD,64.81,
CREDIT,9/13/2017,Online Transfer from SAV ...9660 transaction#: 6514723386,100,ACCT_XFER,135.48,
DEBIT,9/12/2017,PAYPAL           INST XFER  KIGOSAI         WEB ID: PAYPALSI77,-11,ACH_DEBIT,35.48,
CREDIT,9/12/2017,KEY CR. TRANSFER ONLINE-BK  017254026572595 WEB ID: 9000000008,25,ACH_CREDIT,46.48,
DEBIT,9/11/2017,PAYPAL           INST XFER  NEKOKIN         WEB ID: PAYPALSI77,-2.45,ACH_DEBIT,21.48,
DEBIT,9/11/2017,PAYPAL           INST XFER  XSOLLA          WEB ID: PAYPALSI77,-4.99,ACH_DEBIT,23.93,
DEBIT,9/11/2017,PAYPAL           INST XFER  NEKOKIN         WEB ID: PAYPALSI77,-87,ACH_DEBIT,28.92,
DEBIT,9/11/2017,Etsy.com - MimiPrints 718-8557955 NY         09/10,-35.55,DEBIT_CARD,115.92,
DEBIT,9/11/2017,FRED MEYE FRED MEYER 0 BELLINGHAM WA         09/09,-14.57,DEBIT_CARD,151.47,
DEBIT,9/11/2017,FRED MEYE FRED MEYER 0 BELLINGHAM WA         09/09,-10.7,DEBIT_CARD,166.04,
DEBIT,9/11/2017,ATM WITHDRAWAL                       003490  09/091336 CORN,-75,ATM,176.74,
DEBIT,9/11/2017,SHELL Service Station SEATTLE WA     074292  09/09,-40.03,DEBIT_CARD,251.74,
DEBIT,9/11/2017,DICK'S DRIVE-IN WALLING SEATTLE WA           09/09,-7.27,DEBIT_CARD,291.77,
DEBIT,9/11/2017,SQ *VASSILI PROD. LLC Seattle WA             09/09,-17.5,DEBIT_CARD,299.04,
DEBIT,9/11/2017,BOOMERS DRIVE IN BELLINGHAM WA               09/08,-12.96,DEBIT_CARD,316.54,
CREDIT,9/11/2017,VENMO            CASHOUT                    PPD ID: 5264681992,20,ACH_CREDIT,329.5,
CREDIT,9/11/2017,Online Transfer from SAV ...9660 transaction#: 6506928789,75,ACCT_XFER,309.5,
CREDIT,9/11/2017,Online Transfer from SAV ...9660 transaction#: 6508034273,100,ACCT_XFER,234.5,
DEBIT,9/8/2017,FRED MEYE FRED MEYER 0 BELLINGHAM WA         09/08,-19.57,DEBIT_CARD,134.5,
DEBIT,9/8/2017,TACO TIME SAMISH BELLINGHAM WA               09/06,-17.46,DEBIT_CARD,154.07,
DEBIT,9/6/2017,WITHDRAWAL 09/06,-535,MISC_DEBIT,171.53,
DEBIT,9/6/2017,TRANSFER TO SAV XXXXX9660 09/06,-25,ACCT_XFER,706.53,
DEBIT,9/6/2017,EASY STREET RECORDS CAF SEATTLE WA           09/05,-27.12,DEBIT_CARD,731.53,
DEBIT,9/6/2017,BACCO/CHAN SEATTLE WA                        09/05,-42.38,DEBIT_CARD,758.65,
DEBIT,9/5/2017,PAYPAL           INST XFER  PATREON         WEB ID: PAYPALSI77,-2,ACH_DEBIT,801.03,
DEBIT,9/5/2017,350.ORG 646-801-0759 NY                      09/01,-10,DEBIT_CARD,803.03,
DEBIT,9/5/2017,PAYPAL           INST XFER  HAYLEYGG689     WEB ID: PAYPALSI77,-216,ACH_DEBIT,813.03,
DEBIT,9/5/2017,SHELL Service Station SEATTLE WA     091295  09/04,-46.53,DEBIT_CARD,1029.03,
DEBIT,9/5/2017,"SQ *TINY'S ORGANIC, LLC Seattle WA           09/04",-10,DEBIT_CARD,1075.56,
DEBIT,9/5/2017,TOWN & COUNTRY 343 W BAINBRIDGE IS WA953406  09/03,-6.15,DEBIT_CARD,1085.56,
DEBIT,9/1/2017,Online Transfer to  SAV ...9660 transaction#: 6409507086,-50,ACCT_XFER,1091.71,
DEBIT,9/1/2017,RECYCLING AND DISPOSAL FERNDALE WA           08/31,-14.75,DEBIT_CARD,1141.71,
DEBIT,9/1/2017,MCDONALD'S F25879 BELLINGHAM WA              08/30,-6.94,DEBIT_CARD,1156.46,
DEBIT,9/1/2017,U-HAULBELLINGHAM COIN S BELLINGHAM WA        08/30,-69.54,DEBIT_CARD,1163.4,
DEBIT,8/31/2017,FRED MEYE FRED MEYER 0 BELLINGHAM WA         08/31,-24.73,DEBIT_CARD,1232.94,
DEBIT,8/31/2017,SHELL Service Station BELLINGHAM WA  783907  08/31,-2.54,DEBIT_CARD,1257.67,
DEBIT,8/31/2017,RECYCLING AND DISPOSAL FERNDALE WA           08/30,-14.75,DEBIT_CARD,1260.21,
DEBIT,8/31/2017,CASA QUE PASA BELLINGHAM WA                  08/30,-14.07,DEBIT_CARD,1274.96,
DEBIT,8/31/2017,FAIRHAVEN STORAGE BELLINHGAM WA              08/29,-80,DEBIT_CARD,1289.03,
DEBIT,8/30/2017,PAYPAL           INST XFER  HAYLEYGG689     WEB ID: PAYPALSI77,-9.43,ACH_DEBIT,1369.03,
DEBIT,8/30/2017,PAYPAL           INST XFER  HAYLEYGG689     WEB ID: PAYPALSI77,-22.46,ACH_DEBIT,1378.46,
DEBIT,8/30/2017,THE HOME DEPOT #4715 BELLINGHAM WA   401790  08/30,-3.85,DEBIT_CARD,1400.92,
DEBIT,8/30/2017,HAGGEN #3449 BELLINGHAM WA           100932  08/29,-5.47,DEBIT_CARD,1404.77,
CREDIT,8/30/2017,"RAISER,LLC       EDI PAYMNT 339302657       CCD ID: 1800896455",9.8,ACH_CREDIT,1410.24,
CREDIT,8/30/2017,PAYPAL           TRANSFER                   PPD ID: PAYPALSD11,36.66,ACH_CREDIT,1400.44,
CREDIT,8/30/2017,Lyft.com         TRANSFER   Lyft 08-29 Wkly CCD ID: 1800948598,42.63,ACH_CREDIT,1363.78,
DEBIT,8/29/2017,THE HOME DEPOT #4715 BELLINGHAM WA   199329  08/29,-12.52,DEBIT_CARD,1321.15,
DEBIT,8/29/2017,WENDYS 9659 BELLINGHAM WA                    08/28,-8.36,DEBIT_CARD,1333.67,
DEBIT,8/28/2017,FRED MEYER FRED MEYER BELLINGHAM WA  725457  08/28,-2.5,DEBIT_CARD,1342.03,
DEBIT,8/28/2017,SHELL Service Station CUSTER WA      021347  08/26,-43.33,DEBIT_CARD,1344.53,
DEBIT,8/28/2017,FEDEX 787510430319 MEMPHIS TN                08/26,-23.5,DEBIT_CARD,1387.86,
DEBIT,8/25/2017,Dropbox*9S98DSB119QB db.tt/cchelp CA         08/24,-109,DEBIT_CARD,1411.36,
DEBIT,8/25/2017,CASA QUE PASA BELLINGHAM WA                  08/23,-12.67,DEBIT_CARD,1520.36,
DEBIT,8/24/2017,SUKHO THAI BELLEVUE WA                       08/22,-13.85,DEBIT_CARD,1533.03,
CREDIT,8/23/2017,Lyft.com         TRANSFER   Lyft 08-22 Wkly CCD ID: 1800948598,20.62,ACH_CREDIT,1546.88,
CREDIT,8/23/2017,"RAISER,LLC       EDI PAYMNT 332715137       CCD ID: 1800896455",67.06,ACH_CREDIT,1526.26,
CREDIT,8/23/2017,KEY CR. TRANSFER ONLINE-BK  017234832356136 WEB ID: 9000000008,1150,ACH_CREDIT,1459.2,
DEBIT,8/22/2017,TIB-Pike St SEATTLE WA               605033  08/22,-13.87,DEBIT_CARD,309.2,
DEBIT,8/22/2017,SHELL Service Station CHEHALIS WA    030404  08/21,-32.77,DEBIT_CARD,323.07,
DEBIT,8/21/2017,CHEVRON 0305797 SISTERS OR                   08/20,-36.58,DEBIT_CARD,355.84,
DEBIT,8/21/2017,CAMP SHERMAN STORE 541-5956711 OR            08/19,-9.5,DEBIT_CARD,392.42,
DEBIT,8/21/2017,APL* ITUNES.COM/BILL 866-712-7753 CA         08/20,-2.16,DEBIT_CARD,401.92,
DEBIT,8/18/2017,PAYPAL           INST XFER  XSOLLA          WEB ID: PAYPALSI77,-4.99,ACH_DEBIT,404.08,
DEBIT,8/18/2017,VENMO            PAYMENT    633743558       WEB ID: 3264681992,-50,ACH_DEBIT,409.07,
DEBIT,8/18/2017,TARGET T- 1555 N Tomah PORTLAND OR           08/18,-5.55,DEBIT_CARD,459.07,
DEBIT,8/18/2017,SHELL Service Station TUMWATER WA    024279  08/18,-39.04,DEBIT_CARD,464.62,
DEBIT,8/16/2017,PAYPAL           INST XFER  BLIZZARDENT     WEB ID: PAYPALSI77,-16.5,ACH_DEBIT,503.66,
CREDIT,8/16/2017,Lyft.com         TRANSFER   Lyft 08-15 Wkly CCD ID: 1800948598,39.76,ACH_CREDIT,520.16,
CREDIT,8/16/2017,"RAISER,LLC       EDI PAYMNT 326388681       CCD ID: 1800896455",320.92,ACH_CREDIT,480.4,
DEBIT,8/15/2017,FRED MEYE FRED MEYER 6 BELLINGHAM WA         08/15 Purchase $78.66 Cash Back $20.00,-98.66,DEBIT_CARD,159.48,
DEBIT,8/15/2017,FRED MEYE FRED MEYER 6 BELLINGHAM WA         08/15,-3.35,DEBIT_CARD,258.14,
CREDIT,8/15/2017,VENMO            CASHOUT                    PPD ID: 5264681992,11.5,ACH_CREDIT,261.49,
CREDIT,8/15/2017,Online Transfer from SAV ...9660 transaction#: 6445232066,100,ACCT_XFER,249.99,
DEBIT,8/14/2017,SOC FOR NEUROSCIENCE 202-962-4000 DC         08/13,-60,DEBIT_CARD,149.99,
DEBIT,8/14/2017,CHEVRON/ANNETTE HOLDI MOUNT VERNON WA000792  08/13,-38.1,DEBIT_CARD,209.99,
CREDIT,8/14/2017,Online Transfer from SAV ...9660 transaction#: 6440936563,60,ACCT_XFER,248.09,
DEBIT,8/11/2017,PAYPAL           INST XFER  ESADINSKY       WEB ID: PAYPALSI77,-11,ACH_DEBIT,188.09,
DEBIT,8/10/2017,PAYPAL           INST XFER  XSOLLA          WEB ID: PAYPALSI77,-4.99,ACH_DEBIT,199.09,
DEBIT,8/9/2017,WHOLEFDS BLW#106 1030 BELLINGHAM WA  651159  08/09,-10.29,DEBIT_CARD,204.08,
DEBIT,8/9/2017,CHEVRON 0374324 BELLINGHAM WA                08/08,-13.39,DEBIT_CARD,214.37,
DEBIT,8/9/2017,MEDITERRANEAN SPECIALTI BELLINGHAM WA        08/08,-8.29,DEBIT_CARD,227.76,
CREDIT,8/9/2017,Lyft.com         TRANSFER   Lyft 08-08 Wkly CCD ID: 1800948598,9.45,ACH_CREDIT,236.05,
CREDIT,8/9/2017,"RAISER,LLC       EDI PAYMNT 320524293       CCD ID: 1800896455",22.01,ACH_CREDIT,226.6,
DEBIT,8/8/2017,SHELL Service Station TUKWILA WA     084094  08/08,-20.37,DEBIT_CARD,204.59,
DEBIT,8/8/2017,THE WOODS COFFEE LAKEWA BELLINGHAM WA        08/07,-6.65,DEBIT_CARD,224.96,
DEBIT,8/7/2017,TRANSFER TO SAV XXXXX9660 08/07,-25,ACCT_XFER,231.61,
DEBIT,8/7/2017,BELLINGHAM GROC BELLINGHAM WA                08/06,-2.29,DEBIT_CARD,256.61,
DEBIT,8/7/2017,CASA QUE PASA BELLINGHAM WA                  08/05,-11.49,DEBIT_CARD,258.9,
DEBIT,8/7/2017,COMMUNITY FOOD CO-OP - BELLINGHAM WA 377128  08/05,-5.16,DEBIT_CARD,270.39,
DEBIT,8/7/2017,SHELL Service Station TUKWILA WA     040227  08/05,-39.3,DEBIT_CARD,275.55,
DEBIT,8/7/2017,SHELL Service Station TUKWILA WA     031011  08/05,-5.86,DEBIT_CARD,314.85,
DEBIT,8/3/2017,PAYPAL           INST XFER  PARKMOBILE      WEB ID: PAYPALSI77,-4.25,ACH_DEBIT,320.71,
DEBIT,8/3/2017,THE WOODS COFFEE RAILRO BELLINGHAM WA        08/02,-3.71,DEBIT_CARD,324.96,
DEBIT,8/3/2017,HANA TERIYAKI BELLINGHAM WA                  08/02,-11.82,DEBIT_CARD,328.67,
DEBIT,8/2/2017,PAYPAL           INST XFER  PATREON         WEB ID: PAYPALSI77,-2,ACH_DEBIT,340.49,
DEBIT,8/2/2017,350.ORG 646-801-0759 NY                      08/01,-10,DEBIT_CARD,342.49,
CREDIT,8/2/2017,"RAISER,LLC       EDI PAYMNT 314040981       CCD ID: 1800896455",13.11,ACH_CREDIT,352.49,
CREDIT,8/2/2017,Lyft.com         TRANSFER   Lyft 08-01 Wkly CCD ID: 1800948598,35.36,ACH_CREDIT,339.38,
DEBIT,8/1/2017,Online Transfer to  SAV ...9660 transaction#: 6332885536,-50,ACCT_XFER,304.02,
DEBIT,8/1/2017,WWU EMARKETS 360-650-3720 WA                 07/31,-36,DEBIT_CARD,354.02,
DEBIT,8/1/2017,CAPITOL CIDER SEATTLE WA                     07/30,-21.18,DEBIT_CARD,390.02,
DEBIT,7/31/2017,FRED MEYE FRED MEYER 0 BELLINGHAM WA         07/31,-7.29,DEBIT_CARD,411.2,
DEBIT,7/31/2017,BARNESNOBLE 4099 Merid BELLINGHAM WA 529948  07/31,-5.27,DEBIT_CARD,418.49,
DEBIT,7/31/2017,FRED MEYE FRED MEYER 0 BELLINGHAM WA         07/30,-38.49,DEBIT_CARD,423.76,
DEBIT,7/31/2017,PAYMENTS.IMPARK.COM 877-909-6199 BC          07/31,-48,DEBIT_CARD,462.25,
DEBIT,7/31/2017,SHELL Service Station SEATTLE WA     007425  07/30,-42.63,DEBIT_CARD,510.25,
DEBIT,7/31/2017,801 UNIVERSITY KID SEATTLE WA                07/30,-10.33,DEBIT_CARD,552.88,
DEBIT,7/31/2017,The Crescent Lounge Seattle WA               07/30,-14.95,DEBIT_CARD,563.21,
DEBIT,7/31/2017,SQ *MONSTER DOGS Seattle WA                  07/30,-14.4,DEBIT_CARD,578.16,
DEBIT,7/31/2017,SQ *UPTOWN ESPRESSO INC Seattle WA           07/29,-5.25,DEBIT_CARD,592.56,
DEBIT,7/31/2017,SQ *VASSILI PROD. LLC Seattle WA             07/29,-7.5,DEBIT_CARD,597.81,
DEBIT,7/31/2017,TACO TIME SAMISH BELLINGHAM WA               07/28,-11.94,DEBIT_CARD,605.31,
DEBIT,7/31/2017,MUTO RAMEN S IZAKAYA BE BELLINGHAM WA        07/27,-15.51,DEBIT_CARD,617.25,
CREDIT,7/31/2017,Online Transfer from SAV ...9660 transaction#: 6404750461,100,ACCT_XFER,632.76,
DEBIT,7/27/2017,WWU EMARKETS 360-650-3720 WA                 07/26,-36,DEBIT_CARD,532.76,
DEBIT,7/27/2017,USCONNECT ADVGV VEND N FERNDALE WA           07/26,-1.75,DEBIT_CARD,568.76,
DEBIT,7/27/2017,USCONNECT ADVGV VEND N FERNDALE WA           07/26,-1.25,DEBIT_CARD,570.51,
DEBIT,7/26/2017,PAYPAL           INST XFER  HAYLEYGG689     WEB ID: PAYPALSI77,-625,ACH_DEBIT,571.76,
DEBIT,7/26/2017,WALLY S BARBERSHOP BELLINGHAM WA             07/25,-23,DEBIT_CARD,1196.76,
DEBIT,7/26/2017,CITY OF BELLINGHAM PARK BELLINGHAM WA        07/25,-0.59,DEBIT_CARD,1219.76,
DEBIT,7/26/2017,SWEET ALCHEMY ICE CREAM SEATTLE WA           07/24,-9.88,DEBIT_CARD,1220.35,
CREDIT,7/26/2017,"RAISER,LLC       EDI PAYMNT 307979333       CCD ID: 1800896455",32.46,ACH_CREDIT,1230.23,
DEBIT,7/25/2017,HAGGEN #3439 BELLINGHAM WA           895419  07/25,-8.68,DEBIT_CARD,1197.77,
CREDIT,7/25/2017,KEY CR. TRANSFER ONLINE-BK  017205722656729 WEB ID: 9000000008,1150,ACH_CREDIT,1206.45,
DEBIT,7/24/2017,PAYPAL           INST XFER  PARKMOBILE      WEB ID: PAYPALSI77,-4.25,ACH_DEBIT,56.45,
DEBIT,7/24/2017,ATM WITHDRAWAL                       000724  07/234501 UNIV,-20,ATM,60.7,
DEBIT,7/24/2017,SQ *SEATTLE FUSION SEATTLE WA                07/23,-8.25,DEBIT_CARD,80.7,
DEBIT,7/24/2017,SHELL Service Station LYNNWOOD WA    006348  07/22,-46.38,DEBIT_CARD,88.95,
DEBIT,7/24/2017,TACO TIME SAMISH BELLINGHAM WA               07/22,-10.84,DEBIT_CARD,135.33,
DEBIT,7/24/2017,Lyft 07-24 Exp VISA DIRECT CA        532015  07/24,9.38,DEBIT_CARD,146.17,
DEBIT,7/24/2017,Lyft 07-24 Exp VISA DIRECT CA        599730  07/24,9.49,DEBIT_CARD,136.79,
DEBIT,7/21/2017,NON-CHASE ATM FEE-WITH,-2.5,FEE_TRANSACTION,127.3,
DEBIT,7/21/2017,PAYPAL           INST XFER  PARKMOBILE      WEB ID: PAYPALSI77,-4.25,ACH_DEBIT,129.8,
DEBIT,7/21/2017,NON-CHASE ATM WITHDRAW               079075  07/201100 N. S,-12,ATM,134.05,
DEBIT,7/21/2017,USCONNECT ADVGV VEND N FERNDALE WA           07/21,-1.25,DEBIT_CARD,146.05,
DEBIT,7/21/2017,USCONNECT ADVGV VEND N FERNDALE WA           07/21,-1.25,DEBIT_CARD,147.3,
DEBIT,7/21/2017,ARAMARK STARBUCKS BELLINGHAM WA              07/19,-4.95,DEBIT_CARD,148.55,
DEBIT,7/20/2017,USCONNECT ADVGV VEND N FERNDALE WA           07/19,-1.75,DEBIT_CARD,153.5,
DEBIT,7/20/2017,USCONNECT ADVGV VEND N FERNDALE WA           07/19,-1.25,DEBIT_CARD,155.25,
DEBIT,7/20/2017,FEDEX 900191854504 MEMPHIS TN                07/19,-3.25,DEBIT_CARD,156.5,
DEBIT,7/19/2017,ARAMARK ZOES BOOKSIDE B BELLINGHAM WA        07/17,-3.1,DEBIT_CARD,159.75,
DEBIT,7/19/2017,HOTEL HOTEL PIZZA BAR SEATTLE WA             07/14,-10.51,DEBIT_CARD,162.85,
CREDIT,7/19/2017,"RAISER,LLC       EDI PAYMNT 301684033       CCD ID: 1800896455",42.93,ACH_CREDIT,173.36,
DEBIT,7/18/2017,PAYPAL           INST XFER  XSOLLA          WEB ID: PAYPALSI77,-4.99,ACH_DEBIT,130.43,
DEBIT,7/18/2017,FRED MEYE FRED MEYER 0 BELLINGHAM WA         07/18,-16.29,DEBIT_CARD,135.42,
DEBIT,7/17/2017,SHELL Service Station BELLINGHAM WA  009658  07/17,-38.14,DEBIT_CARD,151.71,
DEBIT,7/17/2017,HAGGEN #3449 BELLINGHAM WA           717841  07/16,-5.98,DEBIT_CARD,189.85,
DEBIT,7/17/2017,SQ *VASSILI PROD. LLC Seattle WA             07/15,-17.5,DEBIT_CARD,195.83,
DEBIT,7/17/2017,STARBUCKS STORE 09679 BELLINGHAM WA          07/14,-7.61,DEBIT_CARD,213.33,
DEBIT,7/17/2017,CITY OF BELLINGHAM PARK BELLINGHAM WA        07/14,-1,DEBIT_CARD,220.94,
DEBIT,7/17/2017,LAFEEN`S FAMILY PRIDE D BELLINGHAM WA        07/13,-3,DEBIT_CARD,221.94,
DEBIT,7/17/2017,ARAMARK STARBUCKS BELLINGHAM WA              07/13,-2.93,DEBIT_CARD,224.94,
DEBIT,7/14/2017,PAYPAL           INST XFER  PARKMOBILE      WEB ID: PAYPALSI77,-4.25,ACH_DEBIT,227.87,
DEBIT,7/14/2017,FRED MEYE FRED MEYER 0 BELLINGHAM WA         07/13,-52.11,DEBIT_CARD,232.12,
DEBIT,7/14/2017,APL* ITUNES.COM/BILL 866-712-7753 CA         07/14,-4.33,DEBIT_CARD,284.23,
DEBIT,7/14/2017,BOOMERS DRIVE IN BELLINGHAM WA               07/13,-5.53,DEBIT_CARD,288.56,
DEBIT,7/13/2017,PAYPAL           INST XFER  PARKMOBILE      WEB ID: PAYPALSI77,-4.25,ACH_DEBIT,294.09,
DEBIT,7/13/2017,PAYPAL           INST XFER  PARKMOBILE      WEB ID: PAYPALSI77,-4.25,ACH_DEBIT,298.34,
DEBIT,7/13/2017,USCONNECT ADVGV VEND N FERNDALE WA           07/13,-1.75,DEBIT_CARD,302.59,
DEBIT,7/13/2017,USCONNECT ADVGV VEND N FERNDALE WA           07/13,-1.25,DEBIT_CARD,304.34,
DEBIT,7/13/2017,USCONNECT ADVGV VEND N FERNDALE WA           07/12,-1.25,DEBIT_CARD,305.59,
DEBIT,7/13/2017,USCONNECT ADVGV VEND N FERNDALE WA           07/12,-1.25,DEBIT_CARD,306.84,
DEBIT,7/12/2017,USCONNECT ADVGV VEND N FERNDALE WA           07/12,-1.25,DEBIT_CARD,308.09,
DEBIT,7/12/2017,USCONNECT ADVGV VEND N FERNDALE WA           07/12,-1.25,DEBIT_CARD,309.34,
DEBIT,7/12/2017,ARAMARK STARBUCKS BELLINGHAM WA              07/10,-3.53,DEBIT_CARD,310.59,
CREDIT,7/12/2017,Lyft.com         TRANSFER   Lyft 07-11 Wkly CCD ID: WFMSTRIPE1,29.79,ACH_CREDIT,314.12,
DEBIT,7/11/2017,UBER   *US JUL11 WIVJ 800-592-8996 CA        07/11,-7.84,DEBIT_CARD,284.33,
DEBIT,7/11/2017,USCONNECT ADVGV VEND N FERNDALE WA           07/11,-1.75,DEBIT_CARD,292.17,
DEBIT,7/11/2017,USCONNECT ADVGV VEND N FERNDALE WA           07/11,-1.25,DEBIT_CARD,293.92,
DEBIT,7/11/2017,PEL MENI BELLINGHAM WA                       07/10,-8,DEBIT_CARD,295.17,
DEBIT,7/10/2017,PAYPAL           INST XFER  PARKMOBILE      WEB ID: PAYPALSI77,-4.25,ACH_DEBIT,303.17,
DEBIT,7/10/2017,PAYPAL           INST XFER  XSOLLA          WEB ID: PAYPALSI77,-4.99,ACH_DEBIT,307.42,
DEBIT,7/10/2017,PAYPAL           INST XFER  FANDANGOMED     WEB ID: PAYPALSI77,-14.14,ACH_DEBIT,312.41,
DEBIT,7/10/2017,CASA QUE PASA BELLINGHAM WA                  07/08,-13.12,DEBIT_CARD,326.55,
DEBIT,7/10/2017,USCONNECT ADVGV VEND N FERNDALE WA           07/08,-1.75,DEBIT_CARD,339.67,
DEBIT,7/10/2017,USCONNECT ADVGV VEND N FERNDALE WA           07/08,-1.25,DEBIT_CARD,341.42,
DEBIT,7/10/2017,ARAMARK STARBUCKS BELLINGHAM WA              07/06,-3.64,DEBIT_CARD,342.67,
DEBIT,7/7/2017,USCONNECT ADVGV VEND N FERNDALE WA           07/07,-1.75,DEBIT_CARD,346.31,
DEBIT,7/7/2017,USCONNECT ADVGV VEND N FERNDALE WA           07/07,-1.25,DEBIT_CARD,348.06,
DEBIT,7/7/2017,ARAMARK STARBUCKS BELLINGHAM WA              07/05,-3.26,DEBIT_CARD,349.31,
DEBIT,7/6/2017,TRANSFER TO SAV XXXXX9660 07/06,-25,ACCT_XFER,352.57,
DEBIT,7/5/2017,GROCERY OUTLET BELLINGHAM WA                 07/04,-6.51,DEBIT_CARD,377.57,
DEBIT,7/5/2017,APL* ITUNES.COM/BILL 866-712-7753 CA         07/04,-3.25,DEBIT_CARD,384.08,
DEBIT,7/5/2017,USCONNECT ADVGV VEND N FERNDALE WA           07/04,-1.75,DEBIT_CARD,387.33,
DEBIT,7/5/2017,USCONNECT ADVGV VEND N FERNDALE WA           07/04,-1.25,DEBIT_CARD,389.08,
DEBIT,7/5/2017,ARAMARK VIKING UNION CA BELLINGHAM WA        07/03,-5.48,DEBIT_CARD,390.33,
CREDIT,7/5/2017,VENMO            CASHOUT                    PPD ID: 5264681992,15.75,ACH_CREDIT,395.81,
CREDIT,7/5/2017,"RAISER,LLC       EDI PAYMNT 288413491       CCD ID: 1800896455",45.32,ACH_CREDIT,380.06,
DEBIT,7/5/2017,Lyft 07-04 Exp VISA DIRECT CA        576482  07/03,59.38,DEBIT_CARD,334.74,
DEBIT,7/3/2017,PAYPAL           INST XFER  PATREON         WEB ID: PAYPALSI77,-2,ACH_DEBIT,275.36,
DEBIT,7/3/2017,350.ORG 646-801-0759 NY                      07/01,-10,DEBIT_CARD,277.36,
DEBIT,7/3/2017,PAYPAL           INST XFER  HAYLEYGG689     WEB ID: PAYPALSI77,-16.68,ACH_DEBIT,287.36,
DEBIT,7/3/2017,FRED MEYE FRED MEYER 0 BELLINGHAM WA         07/03,-31.62,DEBIT_CARD,304.04,
DEBIT,7/3/2017,MAPLE FUEL WASH A TON MAPLE FALLS WA         07/01,-5.69,DEBIT_CARD,335.66,
DEBIT,7/3/2017,FRED MEYE FRED MEYER 0 BELLINGHAM WA         06/30 Purchase $12.49 Cash Back $20.00,-32.49,DEBIT_CARD,341.35,
DEBIT,7/3/2017,USCONNECT ADVGV VEND N FERNDALE WA           07/01,-1.25,DEBIT_CARD,373.84,
DEBIT,7/3/2017,CASA QUE PASA BELLINGHAM WA                  06/30,-9.99,DEBIT_CARD,375.09,
DEBIT,7/3/2017,APL* ITUNES.COM/BILL 866-712-7753 CA         06/30,-16.29,DEBIT_CARD,385.08,
DEBIT,7/3/2017,ARAMARK STARBUCKS BELLINGHAM WA              06/29,-3.64,DEBIT_CARD,401.37,
DEBIT,6/30/2017,PAYPAL           INST XFER  PARKMOBILE      WEB ID: PAYPALSI77,-4.25,ACH_DEBIT,405.01,
DEBIT,6/30/2017,Online Transfer to  SAV ...9660 transaction#: 6263175689,-50,ACCT_XFER,409.26,
DEBIT,6/30/2017,USCONNECT ADVGV VEND N FERNDALE WA           06/29,-1.75,DEBIT_CARD,459.26,
DEBIT,6/29/2017,ARAMARK STARBUCKS BELLINGHAM WA              06/27,-6.25,DEBIT_CARD,461.01,
DEBIT,6/28/2017,PAYPAL           INST XFER  PARKMOBILE      WEB ID: PAYPALSI77,-4.25,ACH_DEBIT,467.26,
DEBIT,6/28/2017,PAYPAL           INST XFER  PARKMOBILE      WEB ID: PAYPALSI77,-4.25,ACH_DEBIT,471.51,
DEBIT,6/28/2017,SHELL Service Station BELLINGHAM WA  005094  06/28,-36.73,DEBIT_CARD,475.76,
DEBIT,6/28/2017,COMMUNITY FOOD CO-OP - BELLINGHAM WA 588971  06/28,-3.87,DEBIT_CARD,512.49,
DEBIT,6/28/2017,USCONNECT ADVGV VEND N FERNDALE WA           06/28,-1.25,DEBIT_CARD,516.36,
DEBIT,6/28/2017,USCONNECT ADVGV VEND N FERNDALE WA           06/28,-1.75,DEBIT_CARD,517.61,
DEBIT,6/28/2017,MCDONALD'S F25879 BELLINGHAM WA              06/26,-4.65,DEBIT_CARD,519.36,
CREDIT,6/28/2017,"RAISER,LLC       EDI PAYMNT 285162111       CCD ID: 1800896455",69.18,ACH_CREDIT,524.01,
DEBIT,6/27/2017,NON-CHASE ATM FEE-WITH,-2.5,FEE_TRANSACTION,454.83,
DEBIT,6/27/2017,PAYPAL           INST XFER  HAYLEYGG689     WEB ID: PAYPALSI77,-625,ACH_DEBIT,457.33,
DEBIT,6/27/2017,NON-CHASE ATM WITHDRAW               685155  06/26304 N 36T,-22.95,ATM,1082.33,
DEBIT,6/27/2017,FIAMMA BURGER BELLINGHAM WA                  06/26,-4.8,DEBIT_CARD,1105.28,
DEBIT,6/27/2017,USCONNECT ADVGV VEND N FERNDALE WA           06/26,-1.25,DEBIT_CARD,1110.08,
DEBIT,6/27/2017,USCONNECT ADVGV VEND N FERNDALE WA           06/26,-1.25,DEBIT_CARD,1111.33,
DEBIT,6/27/2017,MINERS LANDING SEATTLE SEATTLE WA            06/25,-10.58,DEBIT_CARD,1112.58,
CREDIT,6/27/2017,KEY CR. TRANSFER ONLINE-BK  017177749379297 WEB ID: 9000000008,150,ACH_CREDIT,1123.16,
DEBIT,6/26/2017,WA DEPT REVENUE  BLS PYMT   367884          WEB ID: 9916001118,-64,ACH_DEBIT,973.16,
DEBIT,6/26/2017,COMMUNITY FOOD CO-OP - BELLINGHAM WA 992391  06/26,-5.16,DEBIT_CARD,1037.16,
DEBIT,6/26/2017,JOHNNY'S GOURMET BURGER STANWOOD WA          06/25,-5.3,DEBIT_CARD,1042.32,
DEBIT,6/26/2017,76 - AMLIB KAUSHIK INC SEATTLE WA            06/25,-38.93,DEBIT_CARD,1047.62,
DEBIT,6/26/2017,AMZN RENTAL PURCHASE AMZN.COM/BILL WA        06/25,-147.81,DEBIT_CARD,1086.55,
DEBIT,6/26/2017,DICK'S DRIVE-IN WALLING SEATTLE WA           06/25,-7.98,DEBIT_CARD,1234.36,
DEBIT,6/26/2017,FRED MEYE FRED MEYER 0 BELLINGHAM WA         06/24,-10.53,DEBIT_CARD,1242.34,
DEBIT,6/26/2017,USCONNECT ADVGV VEND N FERNDALE WA           06/24,-1.25,DEBIT_CARD,1252.87,
DEBIT,6/26/2017,USCONNECT ADVGV VEND N FERNDALE WA           06/24,-1.75,DEBIT_CARD,1254.12,
DEBIT,6/26/2017,USCONNECT ADVGV VEND N FERNDALE WA           06/24,-1.25,DEBIT_CARD,1255.87,
DEBIT,6/26/2017,USCONNECT ADVGV VEND N FERNDALE WA           06/24,-2,DEBIT_CARD,1257.12,
DEBIT,6/23/2017,NON-CHASE ATM FEE-WITH,-2.5,FEE_TRANSACTION,1259.12,
DEBIT,6/23/2017,NON-CHASE ATM WITHDRAW               389787  06/23188E COLL,-43,ATM,1261.62,
DEBIT,6/23/2017,WWU EMARKETS 360-650-3720 WA                 06/22,-235,DEBIT_CARD,1304.62,
DEBIT,6/23/2017,USCONNECT ADVGV VEND N FERNDALE WA           06/22,-1.75,DEBIT_CARD,1539.62,
DEBIT,6/23/2017,PEL MENI BELLINGHAM WA                       06/21,-9,DEBIT_CARD,1541.37,
DEBIT,6/22/2017,SQ *EL CAPITAN'S Bellingham WA               06/22,-7.25,DEBIT_CARD,1550.37,
DEBIT,6/22/2017,UBER   *US JUN21 NRVN 800-592-8996 CA        06/22,-8.57,DEBIT_CARD,1557.62,
DEBIT,6/22/2017,USCONNECT ADVGV VEND N FERNDALE WA           06/22,-1.75,DEBIT_CARD,1566.19,
DEBIT,6/22/2017,ARAMARK STARBUCKS BELLINGHAM WA              06/20,-3.64,DEBIT_CARD,1567.94,
CREDIT,6/22/2017,Online Transfer from SAV ...9660 transaction#: 6314219055,235,ACCT_XFER,1571.58,
DEBIT,6/21/2017,HAGGEN #3439 BELLINGHAM WA           149564  06/20,-10.48,DEBIT_CARD,1336.58,
DEBIT,6/21/2017,HAGGEN #3439 BELLINGHAM WA                   06/20,-6.51,DEBIT_CARD,1347.06,
CREDIT,6/21/2017,"RAISER,LLC       EDI PAYMNT 279859823       CCD ID: 1800896455",127.74,ACH_CREDIT,1353.57,
DEBIT,6/20/2017,76 - S & K VENTURES I MOUNT VERNON WA        06/20,-40.8,DEBIT_CARD,1225.83,
DEBIT,6/20/2017,JIFFY LUBE #2075 SEATTLE WA                  06/19,-63.29,DEBIT_CARD,1266.63,
CREDIT,6/20/2017,KEY CR. TRANSFER ONLINE-BK  017170535047993 WEB ID: 9000000008,1150,ACH_CREDIT,1329.92,
DEBIT,6/19/2017,PAYPAL           INST XFER  XSOLLA          WEB ID: PAYPALSI77,-4.99,ACH_DEBIT,179.92,
DEBIT,6/19/2017,OREILLY AUTO #2 SEATTLE WA                   06/18,-33.01,DEBIT_CARD,184.91,
DEBIT,6/19/2017,FRED MEYE FRED MEYER 0 BELLINGHAM WA         06/18,-9.62,DEBIT_CARD,217.92,
DEBIT,6/19/2017,HAGGEN #3449 BELLINGHAM WA                   06/18,-14.57,DEBIT_CARD,227.54,
DEBIT,6/19/2017,APL* ITUNES.COM/BILL 866-712-7753 CA         06/18,-4.34,DEBIT_CARD,242.11,
DEBIT,6/19/2017,FRED MEYE FRED MEYER 6 BELLINGHAM WA         06/17,-3.35,DEBIT_CARD,246.45,
DEBIT,6/19/2017,FRED MEYER 1225 W BAKE BELLINGHAM WA 920326  06/17,-31.8,DEBIT_CARD,249.8,
DEBIT,6/16/2017,NON-CHASE ATM FEE-WITH,-2.5,FEE_TRANSACTION,281.6,
DEBIT,6/16/2017,NON-CHASE ATM WITHDRAW               258582  06/151100 N. S,-12,ATM,284.1,
DEBIT,6/15/2017,TACO TIME WEST SEATTLE SEATTLE WA            06/13,-11.31,DEBIT_CARD,296.1,
DEBIT,6/14/2017,WA DOL LIC & REG 60134 BELLINGHAM WA 784258  06/14,-85.75,DEBIT_CARD,307.41,
DEBIT,6/14/2017,FRED MEYE FRED MEYER 0 BELLINGHAM WA         06/14,-16.31,DEBIT_CARD,393.16,
DEBIT,6/14/2017,REGAL BARKLEY VILLAGE S BELLINGHAM WA        06/13,-12.53,DEBIT_CARD,409.47,
DEBIT,6/14/2017,VILLA ITALIAN KITCHEN SEATTLE WA             06/13,-4.74,DEBIT_CARD,422,
DEBIT,6/14/2017,JOHNNY ROCKETS 239 SEATTLE WA                06/12,-30.69,DEBIT_CARD,426.74,
DEBIT,6/13/2017,ACE PARKING 3265 SEATTLE WA                  06/12,-18,DEBIT_CARD,457.43,
DEBIT,6/12/2017,PAYPAL           INST XFER  XSOLLA          WEB ID: PAYPALSI77,-4.99,ACH_DEBIT,475.43,
DEBIT,6/12/2017,SQ *A JUKE JOINT PRODUC Seattle WA           06/12,-7.25,DEBIT_CARD,480.42,
DEBIT,6/12/2017,SQ *FULL TILT ICE CREAM Seattle WA           06/12,-4.95,DEBIT_CARD,487.67,
DEBIT,6/12/2017,BALLARD LIQUOR STORE 2 SEATTLE WA            06/11,-11.17,DEBIT_CARD,492.62,
DEBIT,6/12/2017,SENOR MOOSE CAFE SEATTLE WA                  06/10,-19.25,DEBIT_CARD,503.79,
DEBIT,6/12/2017,76 - TWO TWELVE MARKET STANWOOD WA           06/10,-38.17,DEBIT_CARD,523.04,
DEBIT,6/12/2017,WHOLEFDS BLW#106 1030 BELLINGHAM WA  618454  06/10,-13.52,DEBIT_CARD,561.21,
DEBIT,6/12/2017,BAYOU ON BAY BELLINGHAM WA                   06/09,-6,DEBIT_CARD,574.73,
DEBIT,6/12/2017,BAYOU ON BAY BELLINGHAM WA                   06/09,-6,DEBIT_CARD,580.73,
DEBIT,6/9/2017,PAYPAL           INST XFER  HAYLEYGG689     WEB ID: PAYPALSI77,-28.98,ACH_DEBIT,586.73,
DEBIT,6/8/2017,FRED MEYE FRED MEYER 0 BELLINGHAM WA         06/08,-127.26,DEBIT_CARD,615.71,
DEBIT,6/8/2017,USCONNECT ADVGV VEND N FERNDALE WA           06/07,-1.25,DEBIT_CARD,742.97,
DEBIT,6/8/2017,USCONNECT ADVGV VEND N FERNDALE WA           06/07,-1.75,DEBIT_CARD,744.22,
DEBIT,6/7/2017,ARAMARK STARBUCKS BELLINGHAM WA              06/05,-4.07,DEBIT_CARD,745.97,
DEBIT,6/6/2017,TRANSFER TO SAV XXXXX9660 06/06,-25,ACCT_XFER,750.04,
DEBIT,6/6/2017,BOOMERS DRIVE IN BELLINGHAM WA               06/04,-9.92,DEBIT_CARD,775.04,
DEBIT,6/5/2017,CASA QUE PASA BELLINGHAM WA                  06/03,-10.99,DEBIT_CARD,784.96,
DEBIT,6/5/2017,APL* ITUNES.COM/BILL 866-712-7753 CA         06/03,-16.29,DEBIT_CARD,795.95,
DEBIT,6/5/2017,USCONNECT ADVGV VEND N FERNDALE WA           06/03,-1.25,DEBIT_CARD,812.24,
DEBIT,6/5/2017,ARAMARK ZOES BOOKSIDE B BELLINGHAM WA        06/02,-8.77,DEBIT_CARD,813.49,
DEBIT,6/5/2017,ARAMARK ZOES BOOKSIDE B BELLINGHAM WA        06/01,-7.37,DEBIT_CARD,822.26,
CREDIT,6/5/2017,Online Transfer from SAV ...9660 transaction#: 6275878550,200,ACCT_XFER,829.63,
DEBIT,6/2/2017,PAYPAL           INST XFER  PATREON         WEB ID: PAYPALSI77,-2,ACH_DEBIT,629.63,
DEBIT,6/2/2017,350.ORG 646-801-0759 NY                      06/01,-10,DEBIT_CARD,631.63,
DEBIT,6/2/2017,WWU FOUNDATION EMARKE 360-650-3720 WA        06/01,-5,DEBIT_CARD,641.63,
DEBIT,6/2/2017,ARAMARK ATRIUM POD BELLINGHAM WA             05/31,-4.23,DEBIT_CARD,646.63,
DEBIT,6/1/2017,Online Transfer to  SAV ...9660 transaction#: 6189032617,-50,ACCT_XFER,650.86,
DEBIT,6/1/2017,USCONNECT ADVGV VEND N FERNDALE WA           06/01,-1.25,DEBIT_CARD,700.86,
DEBIT,6/1/2017,USCONNECT ADVGV VEND N FERNDALE WA           06/01,-1.25,DEBIT_CARD,702.11,
DEBIT,6/1/2017,ARAMARK STARBUCKS BELLINGHAM WA              05/30,-7.66,DEBIT_CARD,703.36,
DEBIT,5/31/2017,UBER   *US MAY31 RRZV 800-592-8996 CA        05/31,-7.96,DEBIT_CARD,711.02,
DEBIT,5/31/2017,USCONNECT ADVGV VEND N FERNDALE WA           05/30,-1.25,DEBIT_CARD,718.98,
DEBIT,5/31/2017,USCONNECT ADVGV VEND N FERNDALE WA           05/30,-1.75,DEBIT_CARD,720.23,
DEBIT,5/30/2017,PAYPAL           INST XFER  HAYLEYGG689     WEB ID: PAYPALSI77,-625,ACH_DEBIT,721.98,
DEBIT,5/30/2017,KFC/TACO BELL #20502 POULSBO WA              05/29,-19.33,DEBIT_CARD,1346.98,
DEBIT,5/30/2017,CHEVRON 0373890 BAINBRIDGE IS WA             05/29,-33.58,DEBIT_CARD,1366.31,
DEBIT,5/30/2017,TACO TIME SAMISH BELLINGHAM WA               05/28,-6.29,DEBIT_CARD,1399.89,
DEBIT,5/30/2017,UNITED PACIFIC 2 SEDRO WOOLLEY WA    742593  05/28,-5.98,DEBIT_CARD,1406.18,
DEBIT,5/30/2017,FRED MEYER 800 LAKEWAY BELLINGHAM WA 609107  05/27,-34.83,DEBIT_CARD,1412.16,
DEBIT,5/30/2017,FRED MEYE FRED MEYER 0 BELLINGHAM WA         05/26,-4.34,DEBIT_CARD,1446.99,
DEBIT,5/30/2017,ARAMARK ATRIUM POD BELLINGHAM WA             05/26,-7.92,DEBIT_CARD,1451.33,
DEBIT,5/30/2017,ARAMARK MILLER MARKET P BELLINGHAM WA        05/26,-7.37,DEBIT_CARD,1459.25,
DEBIT,5/26/2017,FRED MEYE FRED MEYER 0 BELLINGHAM WA         05/26,-5.46,DEBIT_CARD,1466.62,
DEBIT,5/26/2017,FRED MEYE FRED MEYER 0 BELLINGHAM WA         05/26,-48.03,DEBIT_CARD,1472.08,
DEBIT,5/26/2017,BOOMERS DRIVE IN BELLINGHAM WA               05/24,-23.78,DEBIT_CARD,1520.11,
DEBIT,5/26/2017,ARAMARK ATRIUM POD BELLINGHAM WA             05/24,-4.74,DEBIT_CARD,1543.89,
DEBIT,5/26/2017,ASLAN BREWING CO BELLINGHAM WA               05/21,-8.35,DEBIT_CARD,1548.63,
DEBIT,5/25/2017,USCONNECT ADVGV VEND N FERNDALE WA           05/24,-1.75,DEBIT_CARD,1556.98,
DEBIT,5/25/2017,ARAMARK ATRIUM SUBWAY BELLINGHAM WA          05/23,-7.05,DEBIT_CARD,1558.73,
DEBIT,5/24/2017,USCONNECT ADVGV VEND N FERNDALE WA           05/24,-1.25,DEBIT_CARD,1565.78,
DEBIT,5/24/2017,BOOMERS DRIVE IN BELLINGHAM WA               05/22,-21.13,DEBIT_CARD,1567.03,
DEBIT,5/24/2017,ARAMARK ATRIUM POD BELLINGHAM WA             05/22,-4.87,DEBIT_CARD,1588.16,
DEBIT,5/24/2017,ARAMARK TONYS AT MILLER BELLINGHAM WA        05/22,-4.95,DEBIT_CARD,1593.03,
DEBIT,5/23/2017,USCONNECT ADVGV VEND N FERNDALE WA           05/23,-1.25,DEBIT_CARD,1597.98,
CREDIT,5/23/2017,KEY CR. TRANSFER ONLINE-BK  017142522049488 WEB ID: 9000000008,1150,ACH_CREDIT,1599.23,
DEBIT,5/22/2017,FRED MEYE FRED MEYER 0 BELLINGHAM WA         05/21,-5.28,DEBIT_CARD,449.23,
DEBIT,5/22/2017,SIRENAS GELATO CAFE BELLINGHAM WA            05/20,-7.37,DEBIT_CARD,454.51,
DEBIT,5/22/2017,J DUB'S FILLING STATION BELLINGHAM WA        05/20,-33.44,DEBIT_CARD,461.88,
DEBIT,5/22/2017,COMMUNITY FOOD CO-OP - BELLINGHAM WA 555857  05/20,-3.87,DEBIT_CARD,495.32,
DEBIT,5/22/2017,SQ *MOUNT BAKERY FAIRHA Bellingham WA        05/20,-14.95,DEBIT_CARD,499.19,
DEBIT,5/22/2017,SQ *EL CAPITAN'S Bellingham WA               05/20,-12.08,DEBIT_CARD,514.14,
DEBIT,5/22/2017,MCKAYS TAPHOUSE BELLINGHAM WA                05/19,-6.5,DEBIT_CARD,526.22,
DEBIT,5/22/2017,MCKAYS TAPHOUSE BELLINGHAM WA                05/19,-30.03,DEBIT_CARD,532.72,
DEBIT,5/22/2017,USCONNECT ADVGV VEND N FERNDALE WA           05/20,-1.75,DEBIT_CARD,562.75,
DEBIT,5/22/2017,USCONNECT ADVGV VEND N FERNDALE WA           05/20,-1.25,DEBIT_CARD,564.5,
DEBIT,5/22/2017,ARAMARK ATRIUM POD BELLINGHAM WA             05/19,-5.41,DEBIT_CARD,565.75,
DEBIT,5/22/2017,ARAMARK ROCKS EDGE CAFE BELLINGHAM WA        05/18,-11.28,DEBIT_CARD,571.16,
DEBIT,5/19/2017,UBER   *US MAY18 HFPA 800-592-8996 CA        05/19,-7.49,DEBIT_CARD,582.44,
DEBIT,5/19/2017,76 - STARVIN SAM 2 BELLINGHAM WA             05/18,-15.93,DEBIT_CARD,589.93,
DEBIT,5/19/2017,ARAMARK TOPIOS BELLINGHAM WA                 05/17,-7.48,DEBIT_CARD,605.86,
DEBIT,5/19/2017,ARAMARK STARBUCKS BELLINGHAM WA              05/17,-8.21,DEBIT_CARD,613.34,
DEBIT,5/18/2017,PAYPAL           INST XFER  XSOLLA          WEB ID: PAYPALSI77,-4.99,ACH_DEBIT,621.55,
DEBIT,5/18/2017,WILD BUFFALO BELLINGHAM WA                   05/18,-10.5,DEBIT_CARD,626.54,
DEBIT,5/18/2017,USCONNECT ADVGV VEND N FERNDALE WA           05/17,-1.25,DEBIT_CARD,637.04,
DEBIT,5/18/2017,USCONNECT ADVGV VEND N FERNDALE WA           05/17,-1.75,DEBIT_CARD,638.29,
DEBIT,5/18/2017,ARAMARK ATRIUM POD BELLINGHAM WA             05/16,-4.66,DEBIT_CARD,640.04,
DEBIT,5/18/2017,ARAMARK STARBUCKS BELLINGHAM WA              05/16,-4.95,DEBIT_CARD,644.7,
DEBIT,5/17/2017,UBER   *US MAY17 M4BI 800-592-8996 CA        05/17,-7.83,DEBIT_CARD,649.65,
DEBIT,5/17/2017,USCONNECT ADVGV VEND N FERNDALE WA           05/17,-1.75,DEBIT_CARD,657.48,
DEBIT,5/17/2017,USCONNECT ADVGV VEND N FERNDALE WA           05/17,-1.25,DEBIT_CARD,659.23,
DEBIT,5/17/2017,ARAMARK ATRIUM SUBWAY BELLINGHAM WA          05/15,-1.4,DEBIT_CARD,660.48,
DEBIT,5/17/2017,ARAMARK STARBUCKS BELLINGHAM WA              05/15,-4.84,DEBIT_CARD,661.88,
DEBIT,5/17/2017,ARAMARK MILLER MARKET P BELLINGHAM WA        05/15,-4.66,DEBIT_CARD,666.72,
DEBIT,5/16/2017,USCONNECT ADVGV VEND N FERNDALE WA           05/16,-1.75,DEBIT_CARD,671.38,
DEBIT,5/16/2017,USCONNECT ADVGV VEND N FERNDALE WA           05/16,-1.75,DEBIT_CARD,673.13,
DEBIT,5/16/2017,USCONNECT ADVGV VEND N FERNDALE WA           05/16,-1.75,DEBIT_CARD,674.88,
DEBIT,5/15/2017,PAYPAL           INST XFER  BILLWURTZ       WEB ID: PAYPALSI77,-5,ACH_DEBIT,676.63,
DEBIT,5/15/2017,SEATTLE 684-PARK SEATTLE WA                  05/13,-2,DEBIT_CARD,681.63,
DEBIT,5/15/2017,TACO TIME SAMISH BELLINGHAM WA               05/13,-9.42,DEBIT_CARD,683.63,
DEBIT,5/15/2017,MCKAYS TAPHOUSE BELLINGHAM WA                05/12,-5.5,DEBIT_CARD,693.05,
DEBIT,5/15/2017,PIZZA TIME BELLINGHAM WA                     05/12,-12.45,DEBIT_CARD,698.55,
DEBIT,5/15/2017,PEL MENI BELLINGHAM WA                       05/11,-9.2,DEBIT_CARD,711,
DEBIT,5/11/2017,ARAMARK ZOES BOOKSIDE B BELLINGHAM WA        05/09,-10.03,DEBIT_CARD,720.2,
DEBIT,5/10/2017,PAYPAL           INST XFER  XSOLLA          WEB ID: PAYPALSI77,-4.99,ACH_DEBIT,730.23,
DEBIT,5/10/2017,USCONNECT ADVGV VEND N FERNDALE WA           05/10,-2,DEBIT_CARD,735.22,
DEBIT,5/9/2017,7-ELEVEN SEATTLE WA                          05/08 Purchase $6.28 Cash Back $5.00,-11.28,DEBIT_CARD,737.22,
DEBIT,5/8/2017,TRANSFER TO SAV XXXXX9660 05/08,-25,ACCT_XFER,748.5,
DEBIT,5/8/2017,FRED MEYE FRED MEYER 0 BELLINGHAM WA         05/07,-6.17,DEBIT_CARD,773.5,
DEBIT,5/8/2017,VENMO NEW YORK NY                            05/07,-4.59,DEBIT_CARD,779.67,
DEBIT,5/8/2017,ARAMARK ZOES BOOKSIDE B BELLINGHAM WA        05/04,-5.6,DEBIT_CARD,784.26,
DEBIT,5/5/2017,CAP'S LOUNGE BELLINGHAM WA                   05/03,-5.5,DEBIT_CARD,789.86,
DEBIT,5/5/2017,ARAMARK STARBUCKS BELLINGHAM WA              05/03,-4.84,DEBIT_CARD,795.36,
DEBIT,5/5/2017,ARAMARK ATRIUM POD BELLINGHAM WA             05/03,-8.78,DEBIT_CARD,800.2,
DEBIT,5/4/2017,ANNUAL BRAINSCAPE PRO 8778877815 NY          05/02,-28.7,DEBIT_CARD,808.98,
DEBIT,5/4/2017,ARAMARK ZOES BOOKSIDE B BELLINGHAM WA        05/02,-2.59,DEBIT_CARD,837.68,
DEBIT,5/3/2017,FRED MEYE FRED MEYER 0 BELLINGHAM WA         05/03,-146.58,DEBIT_CARD,840.27,
DEBIT,5/3/2017,ARAMARK STARBUCKS BELLINGHAM WA              05/01,-4.51,DEBIT_CARD,986.85,
DEBIT,5/2/2017,PAYPAL           INST XFER  PATREON         WEB ID: PAYPALSI77,-2,ACH_DEBIT,991.36,
DEBIT,5/2/2017,350.ORG 646-801-0759 NY                      05/01,-10,DEBIT_CARD,993.36,
DEBIT,5/2/2017,CNP*WIRED MAGAZINE 800-769-4733 NY           05/02,2.26,DEBIT_CARD,1003.36,
DEBIT,5/1/2017,Online Transfer to  SAV ...9660 transaction#: 6115026592,-50,ACCT_XFER,1001.1,
DEBIT,5/1/2017,BEAVER INN BELLINGHAM WA                     04/29,-16,DEBIT_CARD,1051.1,
DEBIT,5/1/2017,BEAVER INN BELLINGHAM WA                     04/29,-13.5,DEBIT_CARD,1067.1,
DEBIT,5/1/2017,SQ *REDLIGHT BELLINGHAM Bellingham WA        04/29,-8,DEBIT_CARD,1080.6,
DEBIT,5/1/2017,JUN`S SUSHI & BENTO BELLINGHAM WA            04/29,-16.31,DEBIT_CARD,1088.6,
DEBIT,5/1/2017,APL* ITUNES.COM/BILL 866-712-7753 CA         04/30,-16.29,DEBIT_CARD,1104.91,
DEBIT,5/1/2017,ARAMARK ZOES BOOKSIDE B BELLINGHAM WA        04/27,-8.63,DEBIT_CARD,1121.2,
DEBIT,4/28/2017,FRED MEYE FRED MEYER 0 BELLINGHAM WA         04/28,-10.32,DEBIT_CARD,1129.83,
DEBIT,4/28/2017,ARAMARK MILLER MARKET P BELLINGHAM WA        04/26,-7.48,DEBIT_CARD,1140.15,
DEBIT,4/27/2017,PAYPAL           INST XFER  HAYLEYGG689     WEB ID: PAYPALSI77,-28.41,ACH_DEBIT,1147.63,
DEBIT,4/27/2017,PAYPAL           INST XFER  HAYLEYGG689     WEB ID: PAYPALSI77,-625,ACH_DEBIT,1176.04,
CREDIT,4/25/2017,KEY CR. TRANSFER ONLINE-BK  017114117728049 WEB ID: 9000000008,1136.67,ACH_CREDIT,1801.04,
DEBIT,4/24/2017,COMMUNITY FOOD CO-OP - BELLINGHAM WA 957138  04/23,-14.3,DEBIT_CARD,664.37,
DEBIT,4/24/2017,TRADER JOE'S # 151 BELLINGHAM WA     263965  04/23,-55.64,DEBIT_CARD,678.67,
DEBIT,4/24/2017,TERIYAKI BAR BELLINGHAM WA                   04/22,-15.2,DEBIT_CARD,734.31,
DEBIT,4/24/2017,BOB'S BURGERS & BREW- BELLINGHAM WA          04/22,-17.75,DEBIT_CARD,749.51,
DEBIT,4/24/2017,USCONNECT ADVGV VEND N FERNDALE WA           04/21,-1.25,DEBIT_CARD,767.26,
DEBIT,4/24/2017,ARAMARK ZOES BOOKSIDE B BELLINGHAM WA        04/19,-9.38,DEBIT_CARD,768.51,
DEBIT,4/21/2017,IN *REAL PROPERTY MANA 360-7783518 WA        04/20,-45,DEBIT_CARD,777.89,
DEBIT,4/21/2017,ELIZABETH STATION BELLINGHAM WA              04/19,-2.22,DEBIT_CARD,822.89,
DEBIT,4/21/2017,ARAMARK ATRIUM POD BELLINGHAM WA             04/19,-5.96,DEBIT_CARD,825.11,
DEBIT,4/20/2017,FRED MEYE FRED MEYER 0 BELLINGHAM WA         04/20,-61.65,DEBIT_CARD,831.07,
DEBIT,4/20/2017,FRED MEYER FRED MEYER BELLINGHAM WA  638627  04/20,-0.99,DEBIT_CARD,892.72,
DEBIT,4/20/2017,FRED MEYER FRED MEYER BELLINGHAM WA  511535  04/20,-2.91,DEBIT_CARD,893.71,
DEBIT,4/20/2017,ARAMARK TONYS AT MILLER BELLINGHAM WA        04/17,-5.49,DEBIT_CARD,896.62,
DEBIT,4/19/2017,ARAMARK MILLER MARKET P BELLINGHAM WA        04/17,-3.26,DEBIT_CARD,902.11,
CREDIT,4/19/2017,KEY CR. TRANSFER ONLINE-BK  017108890677584 WEB ID: 9000000008,585,ACH_CREDIT,905.37,
DEBIT,4/18/2017,NON-CHASE ATM FEE-WITH,-2.5,FEE_TRANSACTION,320.37,
DEBIT,4/18/2017,PAYPAL           INST XFER  XSOLLA          WEB ID: PAYPALSI77,-4.99,ACH_DEBIT,322.87,
DEBIT,4/18/2017,NON-CHASE ATM WITHDRAW               462370  04/18516 HIGH,-25,ATM,327.86,
DEBIT,4/18/2017,BOOMERS DRIVE IN BELLINGHAM WA               04/16,-20.25,DEBIT_CARD,352.86,
DEBIT,4/17/2017,Chase QuickPay Electronic Transfer 6156767891 to Devin Crowley,-540,QUICKPAY_DEBIT,373.11,
DEBIT,4/17/2017,FRED MEYE FRED MEYER 0 BELLINGHAM WA         04/15,-30.53,DEBIT_CARD,913.11,
DEBIT,4/17/2017,76 - STARVIN SAMS 14 BELLINGHAM WA           04/16,-43.93,DEBIT_CARD,943.64,
DEBIT,4/17/2017,STARVIN SAMS 14 BELLINGHAM WA        876211  04/15,-4.58,DEBIT_CARD,987.57,
DEBIT,4/17/2017,APL* ITUNES.COM/BILL 866-712-7753 CA         04/15,-4.34,DEBIT_CARD,992.15,
DEBIT,4/17/2017,UBER   *US APR15 6ESY 800-592-8996 CA        04/15,-8.24,DEBIT_CARD,996.49,
DEBIT,4/17/2017,ARAMARK STARBUCKS BELLINGHAM WA              04/14,-8.91,DEBIT_CARD,1004.73,
DEBIT,4/17/2017,ARAMARK TONYS AT MILLER BELLINGHAM WA        04/12,-4.32,DEBIT_CARD,1013.64,
CREDIT,4/17/2017,Online Transfer from SAV ...9660 transaction#: 6156722471,540,ACCT_XFER,1017.96,
DEBIT,4/14/2017,CASA QUE PASA BELLINGHAM WA                  04/12,-16.26,DEBIT_CARD,477.96,
DEBIT,4/14/2017,ARAMARK MILLER MARKET P BELLINGHAM WA        04/12,-8.77,DEBIT_CARD,494.22,
DEBIT,4/13/2017,USCONNECT ADVGV VEND N FERNDALE WA           04/13,-1.25,DEBIT_CARD,502.99,
DEBIT,4/12/2017,HAGGEN FOOD #43 BELLINGHAM WA                04/11,-5.19,DEBIT_CARD,504.24,
DEBIT,4/11/2017,PAYPAL           INST XFER  HAYLEYGG689     WEB ID: PAYPALSI77,-180.24,ACH_DEBIT,509.43,
DEBIT,4/11/2017,RITE AID STORE - 5238 BELLINGHAM WA  256502  04/11,-3.98,DEBIT_CARD,689.67,
DEBIT,4/11/2017,USCONNECT ADVGV VEND N FERNDALE WA           04/11,-1.25,DEBIT_CARD,693.65,
DEBIT,4/11/2017,MAMBO ITALIANO CAFE BELLINGHAM WA            04/10,-37.41,DEBIT_CARD,694.9,
DEBIT,4/10/2017,PAYPAL           INST XFER  XSOLLA          WEB ID: PAYPALSI77,-4.99,ACH_DEBIT,732.31,
DEBIT,4/10/2017,PAYPAL           INST XFER  HAYLEYGG689     WEB ID: PAYPALSI77,-625,ACH_DEBIT,737.3,
DEBIT,4/10/2017,BEST BUY #359 BELLINGHAM WA                  04/09,-53.56,DEBIT_CARD,1362.3,
DEBIT,4/10/2017,SQ *SEATTLE FUSION FEST Seattle WA           04/08,-8.25,DEBIT_CARD,1415.86,
DEBIT,4/10/2017,BIG MARIOS SEATTLE WA                        04/08,-5.27,DEBIT_CARD,1424.11,
DEBIT,4/10/2017,CASTLE MEGASTORE #24 SEATTLE WA              04/08,-55.87,DEBIT_CARD,1429.38,
DEBIT,4/10/2017,SEATTLE METER PARKING SEATTLE WA             04/08,-1.87,DEBIT_CARD,1485.25,
DEBIT,4/10/2017,TIB-Pike St Seattle WA               205340  04/08,-201.04,DEBIT_CARD,1487.12,
DEBIT,4/10/2017,DICK'S DRIVE-IN WALLING SEATTLE WA           04/08,-0.17,DEBIT_CARD,1688.16,
DEBIT,4/10/2017,DICK'S DRIVE-IN WALLING SEATTLE WA           04/08,-7.27,DEBIT_CARD,1688.33,
DEBIT,4/10/2017,SQ *SEATTLE FUSION FEST Seattle WA           04/07,-9,DEBIT_CARD,1695.6,
DEBIT,4/10/2017,ARAMARK ZOES BOOKSIDE B BELLINGHAM WA        04/07,-9.11,DEBIT_CARD,1704.6,
CREDIT,4/10/2017,Online Transfer from SAV ...9660 transaction#: 6137873833,250,ACCT_XFER,1713.71,
DEBIT,4/7/2017,ARAMARK ZOES BOOKSIDE B BELLINGHAM WA        04/05,-1.29,DEBIT_CARD,1463.71,
DEBIT,4/7/2017,ARAMARK ATRIUM POD BELLINGHAM WA             04/05,-8.78,DEBIT_CARD,1465,
DEBIT,4/6/2017,PAYPAL           INST XFER  HAYLEYGG689     WEB ID: PAYPALSI77,-5,ACH_DEBIT,1473.78,
DEBIT,4/6/2017,COMMUNITY FOOD CO-OP - BELLINGHAM WA 298250  04/06,-5.16,DEBIT_CARD,1478.78,
DEBIT,4/6/2017,TRANSFER TO SAV XXXXX9660 04/06,-25,ACCT_XFER,1483.94,
DEBIT,4/6/2017,UBER   *US APR05 MPXA 800-592-8996 CA        04/05,-12.2,DEBIT_CARD,1508.94,
DEBIT,4/6/2017,USCONNECT ADVGV VEND N FERNDALE WA           04/05,-2.25,DEBIT_CARD,1521.14,
DEBIT,4/6/2017,USCONNECT ADVGV VEND N FERNDALE WA           04/05,-2.25,DEBIT_CARD,1523.39,
DEBIT,4/6/2017,APL* ITUNES.COM/BILL 866-712-7753 CA         04/05,-8.67,DEBIT_CARD,1525.64,
DEBIT,4/6/2017,ARAMARK TOPIOS BELLINGHAM WA                 04/03,-7.48,DEBIT_CARD,1534.31,
DEBIT,4/4/2017,FRED MEYE FRED MEYER 0 BELLINGHAM WA         04/03,-28.85,DEBIT_CARD,1541.79,
DEBIT,4/4/2017,USCONNECT ADVGV VEND N FERNDALE WA           04/03,-1.25,DEBIT_CARD,1570.64,
DEBIT,4/3/2017,PAYPAL           INST XFER  PATREON         WEB ID: PAYPALSI77,-2,ACH_DEBIT,1571.89,
DEBIT,4/3/2017,350.ORG 646-801-0759 NY                      04/01,-10,DEBIT_CARD,1573.89,
DEBIT,4/3/2017,ARAMARK TOPIOS BELLINGHAM WA                 03/31,-7.48,DEBIT_CARD,1583.89,
DEBIT,4/3/2017,ARAMARK STARBUCKS BELLINGHAM WA              03/31,-8.04,DEBIT_CARD,1591.37,
DEBIT,4/3/2017,APL* ITUNES.COM/BILL 866-712-7753 CA         03/31,-20.63,DEBIT_CARD,1599.41,
DEBIT,3/31/2017,Online Transfer to  SAV ...9660 transaction#: 6042639538,-50,ACCT_XFER,1620.04,
DEBIT,3/31/2017,BELLINGHAM BAR & GRILL BELLINGHAM WA         03/29,-11.75,DEBIT_CARD,1670.04,
DEBIT,3/30/2017,UBER   *US MAR29 CFXK 800-592-8996 CA        03/30,-7.76,DEBIT_CARD,1681.79,
DEBIT,3/30/2017,ARAMARK VIKING UNION MA BELLINGHAM WA        03/28,-6.28,DEBIT_CARD,1689.55,
DEBIT,3/29/2017,VENMO 855-812-4430 NY                        03/28,-65,DEBIT_CARD,1695.83,
DEBIT,3/28/2017,76 - STARVIN SAMS 14 BELLINGHAM WA           03/27,-29.74,DEBIT_CARD,1760.83,
DEBIT,3/28/2017,HAGGEN FOOD #43 BELLINGHAM WA                03/27,-48.23,DEBIT_CARD,1790.57,
DEBIT,3/27/2017,MYKONOS GREEK GRILL SEATTLE WA               03/25,-32.81,DEBIT_CARD,1838.8,
DEBIT,3/27/2017,BELLINGHAM GROC BELLINGHAM WA                03/25,-68.52,DEBIT_CARD,1871.61,
DEBIT,3/27/2017,WALLY S BARBERSHOP BELLINGHAM WA             03/25,-23,DEBIT_CARD,1940.13,
DEBIT,3/27/2017,ORANGE JULIUS #61456 BELLINGHAM WA           03/24,-3.97,DEBIT_CARD,1963.13,
DEBIT,3/27/2017,CINNABON FERNDALE WA                         03/24,-5.78,DEBIT_CARD,1967.1,
CREDIT,3/27/2017,KEY CR. TRANSFER ONLINE-BK  017083824841909 WEB ID: 9000000008,105.96,ACH_CREDIT,1972.88,
DEBIT,3/24/2017,OFFICE MAX/OFFI 1055 E BELLINGHAM WA 511691  03/24,-105.96,DEBIT_CARD,1866.92,
DEBIT,3/23/2017,SQ *JJ'S IN AND OUT Bellingham WA            03/22,-23.63,DEBIT_CARD,1972.88,
CREDIT,3/23/2017,KEY CR. TRANSFER ONLINE-BK  017081710412205 WEB ID: 9000000008,1136.67,ACH_CREDIT,1996.51,
DEBIT,3/22/2017,PAYPAL           INST XFER  STEAM GAMES     WEB ID: PAYPALSI77,-43.47,ACH_DEBIT,859.84,
DEBIT,3/22/2017,CHEVRON 0094948 BELLINGHAM WA                03/21,-8.6,DEBIT_CARD,903.31,
DEBIT,3/22/2017,CHEVRON 0203477 SEATTLE WA                   03/21,-39.34,DEBIT_CARD,911.91,
DEBIT,3/21/2017,CHEVRON/SALMON SERVICE SEATTLE WA    640585  03/21,-5.52,DEBIT_CARD,951.25,
DEBIT,3/21/2017,WWU EMARKETS 360-650-3720 WA                 03/20,-85,DEBIT_CARD,956.77,
DEBIT,3/20/2017,PAYPAL           INST XFER  XSOLLA          WEB ID: PAYPALSI77,-4.99,ACH_DEBIT,1041.77,
DEBIT,3/20/2017,TOWN & COUNTRY 343 W BAINBRIDGE IS WA622213  03/19,-4.79,DEBIT_CARD,1046.76,
DEBIT,3/20/2017,TOWN & COUNTRY 343 W BAINBRIDGE IS WA453341  03/19,-13.5,DEBIT_CARD,1051.55,
DEBIT,3/20/2017,TACO DEL MAR 400021287 SEATTLE WA            03/19,-6.86,DEBIT_CARD,1065.05,
DEBIT,3/15/2017,ARAMARK ZOES BOOKSIDE B BELLINGHAM WA        03/13,-8.19,DEBIT_CARD,1071.91,
DEBIT,3/15/2017,ARAMARK ZOES BOOKSIDE B BELLINGHAM WA        03/13,-7.05,DEBIT_CARD,1080.1,
DEBIT,3/15/2017,ARAMARK ZOES BOOKSIDE B BELLINGHAM WA        03/13,-6.16,DEBIT_CARD,1087.15,
DEBIT,3/14/2017,BOOMERS DRIVE IN BELLINGHAM WA               03/12,-9.92,DEBIT_CARD,1093.31,
DEBIT,3/13/2017,LOVITT RESTAURANT BELLINGHAM WA              03/11,-36.25,DEBIT_CARD,1103.23,
DEBIT,3/13/2017,ARAMARK ZOES BOOKSIDE B BELLINGHAM WA        03/11,-5.6,DEBIT_CARD,1139.48,
DEBIT,3/13/2017,ARAMARK ZOES BOOKSIDE B BELLINGHAM WA        03/10,-5.6,DEBIT_CARD,1145.08,
DEBIT,3/13/2017,ARAMARK ZOES BOOKSIDE B BELLINGHAM WA        03/10,-6.57,DEBIT_CARD,1150.68,
DEBIT,3/13/2017,PIZZA TIME BELLINGHAM WA                     03/09,-17.75,DEBIT_CARD,1157.25,
DEBIT,3/13/2017,ARAMARK ZOES BOOKSIDE B BELLINGHAM WA        03/09,-7.44,DEBIT_CARD,1175,
DEBIT,3/10/2017,PAYPAL           INST XFER  XSOLLA          WEB ID: PAYPALSI77,-4.99,ACH_DEBIT,1182.44,
DEBIT,3/8/2017,WENDYS-SWL #4023 (9659) BELLINGHAM WA        03/08,-8.46,DEBIT_CARD,1187.43,
DEBIT,3/8/2017,ARAMARK ZOES BOOKSIDE B BELLINGHAM WA        03/06,-6.14,DEBIT_CARD,1195.89,
DEBIT,3/7/2017,WITHDRAWAL 03/07,-758,MISC_DEBIT,1202.03,
CREDIT,3/7/2017,KEY CR. TRANSFER ONLINE-BK  017065062546410 WEB ID: 9000000008,108,ACH_CREDIT,1960.03,
DEBIT,3/6/2017,NON-CHASE ATM FEE-WITH,-2.5,FEE_TRANSACTION,1852.03,
DEBIT,3/6/2017,NON-CHASE ATM WITHDRAW               072817  03/06516 HIGH,-25,ATM,1854.53,
DEBIT,3/6/2017,TRANSFER TO SAV XXXXX9660 03/06,-25,ACCT_XFER,1879.53,
DEBIT,3/6/2017,FEDEXOFFICE   00051219 BELLINGHAM WA         03/04,-13.02,DEBIT_CARD,1904.53,
DEBIT,3/6/2017,ARAMARK ATRIUM POD BELLINGHAM WA             03/03,-2.15,DEBIT_CARD,1917.55,
DEBIT,3/6/2017,ARAMARK ZOES BOOKSIDE B BELLINGHAM WA        03/03,-6.57,DEBIT_CARD,1919.7,
DEBIT,3/6/2017,ARAMARK TOPIOS BELLINGHAM WA                 03/02,-8.46,DEBIT_CARD,1926.27,
DEBIT,3/3/2017,FRED MEYE FRED MEYER 0 BELLINGHAM WA         03/03,-80.92,DEBIT_CARD,1934.73,
DEBIT,3/3/2017,FRED MEYE FRED MEYER 0 BELLINGHAM WA         03/03,-3.24,DEBIT_CARD,2015.65,
DEBIT,3/3/2017,ARAMARK ZOES BOOKSIDE B BELLINGHAM WA        03/01,-0.17,DEBIT_CARD,2018.89,
DEBIT,3/3/2017,ARAMARK MILLER MARKET P BELLINGHAM WA        03/01,-3.26,DEBIT_CARD,2019.06,
DEBIT,3/3/2017,ARAMARK ZOES BOOKSIDE B BELLINGHAM WA        03/01,-6.14,DEBIT_CARD,2022.32,
DEBIT,3/2/2017,350.ORG 646-801-0759 NY                      03/01,-10,DEBIT_CARD,2028.46,
DEBIT,3/2/2017,WENDYS-SWL #4023 (9659) BELLINGHAM WA        03/02,-8.36,DEBIT_CARD,2038.46,
DEBIT,3/2/2017,WWU EMARKETS 360-650-3720 WA                 03/01,-10,DEBIT_CARD,2046.82,
DEBIT,3/1/2017,Online Transfer to  SAV ...9660 transaction#: 5975293246,-50,ACCT_XFER,2056.82,
DEBIT,3/1/2017,ARAMARK ROCKS EDGE CAFE BELLINGHAM WA        02/27,-3.58,DEBIT_CARD,2106.82,
DEBIT,3/1/2017,ARAMARK STARBUCKS BELLINGHAM WA              02/27,-5.49,DEBIT_CARD,2110.4,
DEBIT,3/1/2017,ARAMARK TOPIOS BELLINGHAM WA                 02/27,-8.24,DEBIT_CARD,2115.89,
DEBIT,3/1/2017,ARAMARK MILLER MARKET P BELLINGHAM WA        02/27,-1.63,DEBIT_CARD,2124.13,
DEBIT,2/28/2017,UBER   *US FEB27 5HDT 800-592-8996 CA        02/28,-8.26,DEBIT_CARD,2125.76,
CREDIT,2/28/2017,PAYPAL           TRANSFER                   PPD ID: PAYPALSD11,36,ACH_CREDIT,2134.02,
DEBIT,2/27/2017,76 - STARVIN SAMS 14 BELLINGHAM WA           02/26,-41.53,DEBIT_CARD,2098.02,
DEBIT,2/27/2017,BETH'S CAFE/ DUCK ISLAN SEATTLE WA           02/26,-16.2,DEBIT_CARD,2139.55,
DEBIT,2/27/2017,SQ *ERIN VANCE Seattle WA                    02/26,-10.25,DEBIT_CARD,2155.75,
DEBIT,2/27/2017,ARASHI RAMEN BALLARD SEATTLE WA              02/26,-19.54,DEBIT_CARD,2166,
DEBIT,2/27/2017,COMMUNITY FOOD CO-OP - BELLINGHAM WA 005388  02/25,-8.94,DEBIT_CARD,2185.54,
DEBIT,2/27/2017,WALGREENS STORE 125 S BELLINGHAM WA  415609  02/25,-5.5,DEBIT_CARD,2194.48,
DEBIT,2/27/2017,ARAMARK ZOES BOOKSIDE B BELLINGHAM WA        02/24,-6.14,DEBIT_CARD,2199.98,
DEBIT,2/27/2017,ARAMARK ZOES BOOKSIDE B BELLINGHAM WA        02/23,-3.68,DEBIT_CARD,2206.12,
DEBIT,2/27/2017,BOOMERS DRIVE IN BELLINGHAM WA               02/23,-6.05,DEBIT_CARD,2209.8,
DEBIT,2/24/2017,ARAMARK ZOES BOOKSIDE B BELLINGHAM WA        02/22,-5.82,DEBIT_CARD,2215.85,
CREDIT,2/23/2017,KEY CR. TRANSFER ONLINE-BK  017053538418362 WEB ID: 9000000008,1136.67,ACH_CREDIT,2221.67,
DEBIT,2/22/2017,WWU AS BOOKSTORE BELLINGHAM WA               02/21,-1.88,DEBIT_CARD,1085,
CREDIT,2/22/2017,ROBINHOOD (CRFN) ACH                        PPD ID: 1000101344,252.65,ACH_CREDIT,1086.88,
DEBIT,2/21/2017,PAYPAL           INST XFER  XSOLLA          WEB ID: PAYPALSI77,-4.99,ACH_DEBIT,834.23,
DEBIT,2/21/2017,PAYPAL           INST XFER  KIGOSAI         WEB ID: PAYPALSI77,-14.83,ACH_DEBIT,839.22,
DEBIT,2/21/2017,PAYPAL           INST XFER  HAYLEYGG689     WEB ID: PAYPALSI77,-108,ACH_DEBIT,854.05,
DEBIT,2/21/2017,ATM WITHDRAWAL                       006736  02/201336 CORN,-40,ATM,962.05,
DEBIT,2/21/2017,FRED MEYE FRED MEYER 0 BELLINGHAM WA         02/20,-70.4,DEBIT_CARD,1002.05,
DEBIT,2/21/2017,VENMO 855-812-4430 NY                        02/20,-34,DEBIT_CARD,1072.45,
DEBIT,2/21/2017,COMMUNITY FOOD CO-OP - BELLINGHAM WA 438403  02/19,-9.03,DEBIT_CARD,1106.45,
DEBIT,2/21/2017,REGAL BARKLEY VILLAGE S BELLINGHAM WA        02/19,-16.71,DEBIT_CARD,1115.48,
DEBIT,2/21/2017,ASLAN BREWING CO BELLINGHAM WA               02/17,-32.24,DEBIT_CARD,1132.19,
DEBIT,2/21/2017,WWU EMARKETS 360-650-3720 WA                 02/17,-120,DEBIT_CARD,1164.43,
DEBIT,2/21/2017,ARAMARK ZOES BOOKSIDE B BELLINGHAM WA        02/17,-9.29,DEBIT_CARD,1284.43,
DEBIT,2/17/2017,FIAMMA BURGER BELLINGHAM WA                  02/16,-7.22,DEBIT_CARD,1293.72,
DEBIT,2/17/2017,ARAMARK TONYS AT MILLER BELLINGHAM WA        02/15,-8.2,DEBIT_CARD,1300.94,
DEBIT,2/17/2017,ARAMARK ZOES BOOKSIDE B BELLINGHAM WA        02/15,-10.37,DEBIT_CARD,1309.14,
DEBIT,2/16/2017,FRED MEYE FRED MEYER 0 BELLINGHAM WA         02/15,-75.83,DEBIT_CARD,1319.51,
DEBIT,2/15/2017,USCONNECT ADVANTAGE VEN FERNDALE WA          02/15,-2,DEBIT_CARD,1395.34,
DEBIT,2/15/2017,ARAMARK MILLER MARKET P BELLINGHAM WA        02/13,-6.29,DEBIT_CARD,1397.34,
DEBIT,2/15/2017,ARAMARK MILLER MARKET P BELLINGHAM WA        02/13,-1.29,DEBIT_CARD,1403.63,
DEBIT,2/15/2017,ARAMARK TONYS AT MILLER BELLINGHAM WA        02/13,-6.03,DEBIT_CARD,1404.92,
CREDIT,2/15/2017,IRS  TREAS 310     TAX REF                  PPD ID: 9111736946,733,ACH_CREDIT,1410.95,
DEBIT,2/13/2017,SQ *REDLIGHT BELLINGHAM Bellingham WA        02/12,-8,DEBIT_CARD,677.95,
DEBIT,2/13/2017,BOOMERS DRIVE IN BELLINGHAM WA               02/11,-9.94,DEBIT_CARD,685.95,
DEBIT,2/13/2017,ARAMARK MILLER MARKET P BELLINGHAM WA        02/10,-5.09,DEBIT_CARD,695.89,
DEBIT,2/13/2017,ARAMARK TONYS AT MILLER BELLINGHAM WA        02/10,-4.62,DEBIT_CARD,700.98,
DEBIT,2/10/2017,PAYPAL           INST XFER  XSOLLA          WEB ID: PAYPALSI77,-4.99,ACH_DEBIT,705.6,
DEBIT,2/10/2017,USCONNECT ADVANTAGE VEN FERNDALE WA          02/10,-1.25,DEBIT_CARD,710.59,
DEBIT,2/9/2017,ARAMARK ZOES BOOKSIDE B BELLINGHAM WA        02/07,-6.35,DEBIT_CARD,711.84,
DEBIT,2/8/2017,76 - STARVIN SAMS 14 BELLINGHAM WA           02/07,-40.81,DEBIT_CARD,718.19,
DEBIT,2/8/2017,WWU LIBRARY BELLINGHAM WA                    02/04,-34,DEBIT_CARD,759,
DEBIT,2/7/2017,RITE AID STORE - 5238 BELLINGHAM WA  423308  02/07,-4.65,DEBIT_CARD,793,
DEBIT,2/7/2017,HAGGEN FOOD #43 BELLINGHAM WA        703661  02/07,-10.48,DEBIT_CARD,797.65,
DEBIT,2/7/2017,PIZZA TIME BELLINGHAM WA                     02/05,-12.36,DEBIT_CARD,808.13,
DEBIT,2/7/2017,ARAMARK ZOES BOOKSIDE B BELLINGHAM WA        02/05,-6.69,DEBIT_CARD,820.49,
DEBIT,2/6/2017,AmazonPrime Membersh amzn.com/prme WA        02/03,-53.26,DEBIT_CARD,827.18,
DEBIT,2/6/2017,TRANSFER TO SAV XXXXX9660 02/06,-25,ACCT_XFER,880.44,
DEBIT,2/6/2017,ARAMARK ZOES BOOKSIDE B BELLINGHAM WA        02/04,-6.14,DEBIT_CARD,905.44,
DEBIT,2/6/2017,TACO TIME SAMISH BELLINGHAM WA               02/04,-10.08,DEBIT_CARD,911.58,
DEBIT,2/6/2017,ARAMARK ATRIUM POD BELLINGHAM WA             02/03,-3.26,DEBIT_CARD,921.66,
DEBIT,2/6/2017,ARAMARK ATRIUM POD BELLINGHAM WA             02/03,-5.52,DEBIT_CARD,924.92,
DEBIT,2/6/2017,BOOMERS DRIVE IN BELLINGHAM WA               02/02,-3.75,DEBIT_CARD,930.44,
DEBIT,2/3/2017,PAYPAL           INST XFER  NEKOKIN         WEB ID: PAYPALSI77,-15,ACH_DEBIT,934.19,
DEBIT,2/3/2017,USCONNECT ADVANTAGE VEN FERNDALE WA          02/03,-1.25,DEBIT_CARD,949.19,
DEBIT,2/3/2017,USCONNECT ADVANTAGE VEN FERNDALE WA          02/03,-2,DEBIT_CARD,950.44,
DEBIT,2/3/2017,ARAMARK ZOES BOOKSIDE B BELLINGHAM WA        02/01,-6.69,DEBIT_CARD,952.44,
CREDIT,2/3/2017,KEY CR. TRANSFER ONLINE-BK  017032743187705 WEB ID: 9000000008,155,ACH_CREDIT,959.13,
DEBIT,2/2/2017,FRED MEYE FRED MEYER 0 BELLINGHAM WA         02/02,-32.37,DEBIT_CARD,804.13,
DEBIT,2/2/2017,350.ORG 646-801-0759 NY                      02/01,-10,DEBIT_CARD,836.5,
DSLIP,2/2/2017,DEPOSIT  ID NUMBER 323893,50,DEPOSIT,846.5,
DEBIT,2/1/2017,Online Transfer to  SAV ...9660 transaction#: 5901902675,-50,ACCT_XFER,796.5,
DEBIT,1/31/2017,WWU AS BOOKSTORE BELLINGHAM WA               01/30,-8.94,DEBIT_CARD,846.5,
DEBIT,1/30/2017,ARAMARK ZOES BOOKSIDE B BELLINGHAM WA        01/27,-4.98,DEBIT_CARD,855.44,
DEBIT,1/30/2017,ARAMARK ZOES BOOKSIDE B BELLINGHAM WA        01/26,-6.69,DEBIT_CARD,860.42,
DEBIT,1/30/2017,ARAMARK TOPIOS BELLINGHAM WA                 01/26,-4.12,DEBIT_CARD,867.11,
DEBIT,1/27/2017,PAYPAL           INST XFER  HAYLEYGG689     WEB ID: PAYPALSI77,-625,ACH_DEBIT,871.23,
DEBIT,1/27/2017,FRED MEYE FRED MEYER 0 BELLINGHAM WA         01/26,-97.79,DEBIT_CARD,1496.23,
DEBIT,1/27/2017,WWU PRINT AND COPY SERV BELLINGHAM WA        01/26,-4,DEBIT_CARD,1594.02,
DEBIT,1/27/2017,USCONNECT ADVANTAGE VEN FERNDALE WA          01/27,-2,DEBIT_CARD,1598.02,
DEBIT,1/27/2017,ARAMARK ATRIUM SUBWAY BELLINGHAM WA          01/25,-7.05,DEBIT_CARD,1600.02,
DEBIT,1/27/2017,ARAMARK ZOES BOOKSIDE B BELLINGHAM WA        01/25,-8.73,DEBIT_CARD,1607.07,
CREDIT,1/26/2017,ROBINHOOD (CRFN) ACH                        PPD ID: 1000101344,13.85,ACH_CREDIT,1615.8,
CHECK,1/25/2017,CHECK 143986374  ,-30,CHECK_PAID,1601.95,143986374
DEBIT,1/25/2017,ARAMARK MILLER MARKET P BELLINGHAM WA        01/23,-5.44,DEBIT_CARD,1631.95,
DEBIT,1/25/2017,ARAMARK ZOES BOOKSIDE B BELLINGHAM WA        01/23,-7.33,DEBIT_CARD,1637.39,
CREDIT,1/25/2017,"RAISER,LLC       EDI PAYMNT 0177243505      CCD ID: 1800896455",10.42,ACH_CREDIT,1644.72,
DEBIT,1/24/2017,DICK'S DRIVE-IN WALLING SEATTLE WA           01/23,-9.64,DEBIT_CARD,1634.3,
CREDIT,1/24/2017,KEY CR. TRANSFER ONLINE-BK  017023377761582 WEB ID: 9000000008,1136.67,ACH_CREDIT,1643.94,
DEBIT,1/23/2017,SQ *MAN PIES Bellingham WA                   01/21,-21.82,DEBIT_CARD,507.27,
DEBIT,1/23/2017,ARAMARK ZOES BOOKSIDE B BELLINGHAM WA        01/20,-3.64,DEBIT_CARD,529.09,
CREDIT,1/18/2017,"RAISER,LLC       EDI PAYMNT 0172908405      CCD ID: 1800896455",3.83,ACH_CREDIT,532.73,
CREDIT,1/18/2017,Lyft.com         TRANSFER   Lyft 01-17 Wkly CCD ID: WFMSTRIPE1,31.02,ACH_CREDIT,528.9,
DEBIT,1/17/2017,HAGGEN FOOD #43 BELLINGHAM WA        765994  01/17,-93.42,DEBIT_CARD,497.88,
DEBIT,1/17/2017,CHEVRON/SALMON SERVICE SEATTLE WA    087731  01/14,-41.67,DEBIT_CARD,591.3,
DEBIT,1/17/2017,THE MOUNT BAKERY BELLINGHAM WA               01/14,-42.15,DEBIT_CARD,632.97,
DEBIT,1/17/2017,ARAMARK ATRIUM POD BELLINGHAM WA             01/13,-7.92,DEBIT_CARD,675.12,
DEBIT,1/17/2017,ARAMARK UNDERGROUND COF BELLINGHAM WA        01/10,-2.71,DEBIT_CARD,683.04,
DEBIT,1/13/2017,ARAMARK ZOES BOOKSIDE B BELLINGHAM WA        01/11,-7.65,DEBIT_CARD,685.75,
DEBIT,1/13/2017,ARAMARK ZOES BOOKSIDE B BELLINGHAM WA        01/11,-7.44,DEBIT_CARD,693.4,
DEBIT,1/13/2017,GAMEWORKS SEATTLE SEATTLE WA                 12/30,-18.47,DEBIT_CARD,700.84,
DEBIT,1/11/2017,ARAMARK ATRIUM POD BELLINGHAM WA             01/09,-6.51,DEBIT_CARD,719.31,
CREDIT,1/11/2017,"RAISER,LLC       EDI PAYMNT 0167874523      CCD ID: 1800896455",16.84,ACH_CREDIT,725.82,
DEBIT,1/10/2017,PAYPAL           INST XFER  XSOLLA          WEB ID: PAYPALSI77,-4.99,ACH_DEBIT,708.98,
DEBIT,1/9/2017,BOOMERS DRIVE IN BELLINGHAM WA               01/07,-9.94,DEBIT_CARD,713.97,
DEBIT,1/9/2017,ARAMARK MILLER MARKET P BELLINGHAM WA        01/06,-4.35,DEBIT_CARD,723.91,
DEBIT,1/6/2017,TRANSFER TO SAV XXXXX9660 01/06,-25,ACCT_XFER,728.26,
DEBIT,1/6/2017,ARAMARK MILLER MARKET P BELLINGHAM WA        01/04,-1.29,DEBIT_CARD,753.26,
DEBIT,1/6/2017,ARAMARK ATRIUM POD BELLINGHAM WA             01/04,-8.24,DEBIT_CARD,754.55,
DEBIT,1/5/2017,PAYPAL           INST XFER  SLHOMEWORK      WEB ID: PAYPALSI77,-22.5,ACH_DEBIT,762.79,
DEBIT,1/5/2017,PAYPAL           INST XFER  HAYLEYGG689     WEB ID: PAYPALSI77,-41.49,ACH_DEBIT,785.29,
DEBIT,1/4/2017,FRED MEYE FRED MEYER 0 BELLINGHAM WA         01/04,-64.05,DEBIT_CARD,826.78,
CREDIT,1/4/2017,Lyft.com         TRANSFER   Lyft 01-03 Wkly CCD ID: WFMSTRIPE1,3,ACH_CREDIT,890.83,
DEBIT,1/3/2017,PAYPAL           INST XFER  STEAM GAMES     WEB ID: PAYPALSI77,-11.72,ACH_DEBIT,887.83,
DEBIT,1/3/2017,WHOLEFDS BLW#106 1030 BELLINGHAM WA  363942  01/03,-17.33,DEBIT_CARD,899.55,
DEBIT,1/3/2017,NBG LLC NORTH BEND WA                746859  01/02,-6.33,DEBIT_CARD,916.88,
DEBIT,1/3/2017,FB *Robert Berman pay.fb.com CA              01/02,-12,DEBIT_CARD,923.21,
DEBIT,1/3/2017,RAZZAL'S AT SMOKEY P ARLINGTON WA            12/31,-30.11,DEBIT_CARD,935.21,
DEBIT,1/3/2017,STARBUCKS STORE 20088 SEATTLE WA             12/31,-12.33,DEBIT_CARD,965.32,
DEBIT,1/3/2017,IMPARK00250145A SEATTLE WA                   12/31,-21,DEBIT_CARD,977.65,
DEBIT,1/3/2017,TROPHY CUPCAKES SEATTLE WA                   12/31,-10.3,DEBIT_CARD,998.65,
DEBIT,1/3/2017,LYFT   *RIDE SAT 10AM LYFT.COM CA            12/31,-8.14,DEBIT_CARD,1008.95,
DEBIT,1/3/2017,GAMEWORKS SEATTLE WA                         12/30,-22,DEBIT_CARD,1017.09,
DEBIT,1/3/2017,JOHNNY ROCKETS 239 SEATTLE WA                12/30,-10.44,DEBIT_CARD,1039.09,
DEBIT,1/3/2017,SHELL Service Station SEATTLE WA     079557  12/30,-12.25,DEBIT_CARD,1049.53,
DEBIT,1/3/2017,CHEVRON 0211635 BELLINGHAM WA                12/30,-15.71,DEBIT_CARD,1061.78,
DEBIT,1/3/2017,GREEN FROG BELLINGHAM WA                     12/29,-11.5,DEBIT_CARD,1077.49,
DEBIT,1/3/2017,Lyft 01-01 Exp Visa Direct CA        002297  01/01,380.78,DEBIT_CARD,1088.99,
DEBIT,12/30/2016,Online Transfer to  SAV ...9660 transaction#: 5834453776,-50,ACCT_XFER,708.21,
DEBIT,12/29/2016,FRED MEYE FRED MEYER 0 BELLINGHAM WA         12/29,-6.86,DEBIT_CARD,758.21,
DEBIT,12/29/2016,UNICORN/NARWHAL SEATTLE WA                   12/27,-25.13,DEBIT_CARD,765.07,
DEBIT,12/29/2016,DICK'S DRIVE-IN BROADWA SEATTLE WA           12/27,-3.4,DEBIT_CARD,790.2,
DEBIT,12/28/2016,PAYPAL           INST XFER  HAYLEYGG689     WEB ID: PAYPALSI77,-625,ACH_DEBIT,793.6,
DEBIT,12/28/2016,CHEVRON 0207721 SEATTLE WA                   12/28,-39.81,DEBIT_CARD,1418.6,
CREDIT,12/28/2016,"RAISER,LLC       EDI PAYMNT 0159396365      CCD ID: 1800896455",95.5,ACH_CREDIT,1458.41,
DEBIT,12/27/2016,PAYPAL           INST XFER  REDDIT GOLD     WEB ID: PAYPALSI77,-3.99,ACH_DEBIT,1362.91,
DEBIT,12/27/2016,PAYPAL           INST XFER  REDDIT GOLD     WEB ID: PAYPALSI77,-3.99,ACH_DEBIT,1366.9,
DEBIT,12/27/2016,OREILLY AUTO PARTS 252 SEATTLE WA            12/27,-8.22,DEBIT_CARD,1370.89,
DEBIT,12/27/2016,OREILLY AUTO PARTS 252 SEATTLE WA            12/27,-13.69,DEBIT_CARD,1379.11,
DEBIT,12/27/2016,EAGLE HARBOR BOOKS BAINBRIDGE IS WA          12/24,-23.9,DEBIT_CARD,1392.8,
DEBIT,12/27/2016,SUBWAY        01466374 SEATTLE WA            12/24,-8.93,DEBIT_CARD,1416.7,
DEBIT,12/27/2016,SQ *THE HANDMADE SHOWRO Seattle WA           12/23,-23.02,DEBIT_CARD,1425.63,
DEBIT,12/27/2016,SQ *THE HANDMADE KITCHE Seattle WA           12/23,-36.17,DEBIT_CARD,1448.65,
DEBIT,12/27/2016,STARBUCKS STORE 24666 SEATTLE WA             12/23,-35,DEBIT_CARD,1484.82,
DEBIT,12/27/2016,IMPARK00250058U SEATTLE WA                   12/24,-7.35,DEBIT_CARD,1519.82,
DEBIT,12/27/2016,KFC E080081 SAMMAMISH WA                     12/23,-7.11,DEBIT_CARD,1527.17,
DEBIT,12/27/2016,CHEVRON 0204893 SAMMAMISH WA                 12/23,-39.29,DEBIT_CARD,1534.28,
DEBIT,12/27/2016,FEDEXOFFICE   00051219 BELLINGHAM WA         12/23,-10.85,DEBIT_CARD,1573.57,
DEBIT,12/27/2016,BELLINGHAM FRAMEWORKS BELLINGHAM WA          12/23,-25.98,DEBIT_CARD,1584.42,
DEBIT,12/27/2016,APL* ITUNES.COM/BILL 866-712-7753 CA         12/23,-16.29,DEBIT_CARD,1610.4,
DSLIP,12/27/2016,REMOTE ONLINE DEPOSIT #          1,75,CHECK_DEPOSIT,1626.69,1
DEBIT,12/27/2016,Lyft 12-27 Exp Visa Direct CA        841817  12/26,21.16,DEBIT_CARD,1551.69,
DEBIT,12/27/2016,Lyft 12-27 Exp Visa Direct CA        841819  12/26,50.11,DEBIT_CARD,1530.53,
DEBIT,12/27/2016,Lyft 12-25 Exp Visa Direct CA        802179  12/25,51.79,DEBIT_CARD,1480.42,
DEBIT,12/27/2016,Lyft 12-26 Exp Visa Direct CA        819693  12/25,52.3,DEBIT_CARD,1428.63,
DEBIT,12/27/2016,Lyft 12-27 Exp Visa Direct CA        854448  12/27,72.64,DEBIT_CARD,1376.33,
DEBIT,12/23/2016,PAPYRUS #2158 600 PINE SEATTLE WA    521431  12/23,-16.43,DEBIT_CARD,1303.69,
DEBIT,12/23/2016,PACIFIC PLACE SEATTLE WA             006726  12/23,-21.91,DEBIT_CARD,1320.12,
CREDIT,12/23/2016,KEY CR. TRANSFER ONLINE-BK  016357243669156 WEB ID: 9000000008,1136.67,ACH_CREDIT,1342.03,
DEBIT,12/21/2016,FRED MEYE FRED MEYER 0 BELLINGHAM WA         12/21,-24.45,DEBIT_CARD,205.36,
DEBIT,12/21/2016,BELLINGHAM GROC BELLINGHAM WA                12/21,-37.92,DEBIT_CARD,229.81,
DEBIT,12/21/2016,DICK'S DRIVE-IN WALLING SEATTLE WA           12/19,-5.37,DEBIT_CARD,267.73,
CREDIT,12/21/2016,"RAISER,LLC       EDI PAYMNT 0155338757      CCD ID: 1800896455",78.9,ACH_CREDIT,273.1,
DEBIT,12/20/2016,CHEVRON 0373890 BAINBRIDGE IS WA             12/19,-36.45,DEBIT_CARD,194.2,
DEBIT,12/20/2016,BLUE C SUSHI SEATTLE WA                      12/18,-22.73,DEBIT_CARD,230.65,
DEBIT,12/19/2016,PAYPAL           INST XFER  ALISSACLEO      WEB ID: PAYPALSI77,-20,ACH_DEBIT,253.38,
DEBIT,12/19/2016,USA*SODEXO SEATTLE WA                        12/19,-1.75,DEBIT_CARD,273.38,
DEBIT,12/19/2016,THE ESSENTIAL BAKING CO SEATTLE WA           12/18,-8.95,DEBIT_CARD,275.13,
DEBIT,12/19/2016,RITE AID STORE - 521 BAINBRIDGE IS WA        12/17,-44.31,DEBIT_CARD,284.08,
DEBIT,12/19/2016,UW COMMUTER SVCS PAY ST SEATTLE WA           12/16,-12.75,DEBIT_CARD,328.39,
DEBIT,12/19/2016,MCKAYS TAPHOUSE BELLINGHAM WA                12/16,-11.5,DEBIT_CARD,341.14,
DEBIT,12/16/2016,ATM WITHDRAWAL                       007750  12/161336 CORN,-40,ATM,352.64,
DEBIT,12/16/2016,CASA QUE PASA BELLINGHAM WA                  12/14,-9.68,DEBIT_CARD,392.64,
DEBIT,12/15/2016,PAYPAL           INST XFER  KIGOSAI         WEB ID: PAYPALSI77,-6,ACH_DEBIT,402.32,
DEBIT,12/15/2016,COMMUNITY FOOD CO-OP - BELLINGHAM WA 828850  12/15,-3.87,DEBIT_CARD,408.32,
CREDIT,12/15/2016,PAYPAL           TRANSFER                   PPD ID: PAYPALSD11,30,ACH_CREDIT,412.19,
DEBIT,12/14/2016,FIRESTONE 655643 BELLINGHAM WA               12/13,-10.86,DEBIT_CARD,382.19,
DEBIT,12/14/2016,VENMO 855-812-4430 NY                        12/13,-60,DEBIT_CARD,393.05,
CREDIT,12/14/2016,PAYPAL           TRANSFER                   PPD ID: PAYPALSD11,36,ACH_CREDIT,453.05,
DEBIT,12/13/2016,APL* ITUNES.COM/BILL 866-712-7753 CA         12/13,-5.42,DEBIT_CARD,417.05,
DEBIT,12/13/2016,WWU EMARKETS 360-650-3720 WA                 12/12,-85,DEBIT_CARD,422.47,
DEBIT,12/12/2016,PAYPAL           INST XFER  KIGOSAI         WEB ID: PAYPALSI77,-3.9,ACH_DEBIT,507.47,
DEBIT,12/12/2016,PAYPAL           INST XFER  XSOLLA          WEB ID: PAYPALSI77,-4.99,ACH_DEBIT,511.37,
DEBIT,12/12/2016,FRED MEYE FRED MEYER 0 BELLINGHAM WA         12/11,-12.7,DEBIT_CARD,516.36,
DEBIT,12/12/2016,BELLINGHAM GROC BELLINGHAM WA                12/10,-49.68,DEBIT_CARD,529.06,
DEBIT,12/12/2016,SHELL Service Station BELLINGHAM WA  005802  12/10,-40.99,DEBIT_CARD,578.74,
DEBIT,12/12/2016,SHELL Service Station BELLINGHAM WA  295141  12/10,-2.99,DEBIT_CARD,619.73,
DEBIT,12/12/2016,TERIYAKI BAR BELLINGHAM WA                   12/09,-11.45,DEBIT_CARD,622.72,
DEBIT,12/12/2016,MT BAKER SKI AREA INC BELLINGHAM WA          12/08,-143.07,DEBIT_CARD,634.17,
DEBIT,12/12/2016,MT BAKER SKI AREA INC BELLINGHAM WA          12/08,-55.08,DEBIT_CARD,777.24,
CREDIT,12/12/2016,Online Transfer from SAV ...9660 transaction#: 5862240035,70,ACCT_XFER,832.32,
CREDIT,12/12/2016,Online Transfer from SAV ...9660 transaction#: 5859125273,300,ACCT_XFER,762.32,
DEBIT,12/9/2016,PAYPAL           INST XFER  DFTBARECORD     WEB ID: PAYPALSI77,-35,ACH_DEBIT,462.32,
DEBIT,12/9/2016,MT BAKER SKI FOOD SERV BELLINGHAM WA         12/08,-4,DEBIT_CARD,497.32,
DEBIT,12/9/2016,RUDY'S PIZZERIA BELLINGHAM WA                12/08,-5.17,DEBIT_CARD,501.32,
DEBIT,12/8/2016,SQ *EL CAPITAN'S Bellingham WA               12/08,-7.75,DEBIT_CARD,506.49,
DEBIT,12/8/2016,SQ *REDLIGHT BELLINGHAM Bellingham WA        12/08,-9,DEBIT_CARD,514.24,
DEBIT,12/8/2016,UBER   *US DEC07 SR2Q 866-576-1039 CA        12/08,-9.69,DEBIT_CARD,523.24,
DEBIT,12/7/2016,FRED MEYE FRED MEYER 0 BELLINGHAM WA         12/07,-49.97,DEBIT_CARD,532.93,
DEBIT,12/7/2016,USCONNECT ADVANTAGE VEN FERNDALE WA          12/07,-1.75,DEBIT_CARD,582.9,
DEBIT,12/7/2016,ARAMARK ZOES BOOKSIDE B BELLINGHAM WA        12/05,-7.58,DEBIT_CARD,584.65,
DEBIT,12/6/2016,TRANSFER TO SAV XXXXX9660 12/06,-25,ACCT_XFER,592.23,
DEBIT,12/6/2016,WENDYS-SWL #4023 (9659) BELLINGHAM WA        12/05,-8.24,DEBIT_CARD,617.23,
DEBIT,12/5/2016,PAYPAL           INST XFER  HAYLEYGG689     WEB ID: PAYPALSI77,-620,ACH_DEBIT,625.47,
DEBIT,12/5/2016,ARAMARK ZOES BOOKSIDE B BELLINGHAM WA        12/03,-11.86,DEBIT_CARD,1245.47,
DEBIT,12/5/2016,ARAMARK TOPIOS BELLINGHAM WA                 11/30,-7.59,DEBIT_CARD,1257.33,
DEBIT,12/2/2016,FRED MEYE FRED MEYER 0 BELLINGHAM WA         12/02,-15.17,DEBIT_CARD,1264.92,
DEBIT,12/2/2016,SQ *REDLIGHT BELLINGHAM Bellingham WA        12/02,-10.35,DEBIT_CARD,1280.09,
DEBIT,12/2/2016,FIRESTONE 655643 BELLINGHAM WA               12/01,-10.86,DEBIT_CARD,1290.44,
DEBIT,12/2/2016,BELLINGHAM MUSIC BELLINGHAM WA               12/01,-24.99,DEBIT_CARD,1301.3,
DEBIT,12/1/2016,Online Transfer to  SAV ...9660 transaction#: 5767449319,-50,ACCT_XFER,1326.29,
DEBIT,12/1/2016,UBER   *US NOV30 UJZ7 866-576-1039 CA        12/01,-8.92,DEBIT_CARD,1376.29,
DEBIT,11/29/2016,PAYPAL           INST XFER  NEKOKIN         WEB ID: PAYPALSI77,-16,ACH_DEBIT,1385.21,
DEBIT,11/29/2016,PAYPAL           INST XFER  NEKOKIN         WEB ID: PAYPALSI77,-21,ACH_DEBIT,1401.21,
DEBIT,11/29/2016,HAGGEN FOOD #43 BELLINGHAM WA        796352  11/28,-13.02,DEBIT_CARD,1422.21,
DEBIT,11/29/2016,UBER   *US NOV28 KRQL 866-576-1039 CA        11/29,-7.21,DEBIT_CARD,1435.23,
DEBIT,11/29/2016,USCONNECT ADVANTAGE VEN FERNDALE WA          11/29,-1.75,DEBIT_CARD,1442.44,
CREDIT,11/29/2016,KEY CR. TRANSFER ONLINE BK  000000013115637 WEB ID: 9000000008,300.18,ACH_CREDIT,1444.19,
DEBIT,11/28/2016,NON-CHASE ATM FEE-WITH,-2.5,FEE_TRANSACTION,1144.01,
DEBIT,11/28/2016,NON-CHASE ATM WITHDRAW               160229  11/28516 HIGH,-25,ATM,1146.51,
DEBIT,11/28/2016,USCONNECT ADVANTAGE VEN FERNDALE WA          11/28,-1.75,DEBIT_CARD,1171.51,
DEBIT,11/28/2016,USCONNECT ADVANTAGE VEN FERNDALE WA          11/28,-1.75,DEBIT_CARD,1173.26,
DEBIT,11/28/2016,USCONNECT ADVANTAGE VEN FERNDALE WA          11/28,-1.25,DEBIT_CARD,1175.01,
DEBIT,11/28/2016,USCONNECT ADVANTAGE VEN FERNDALE WA          11/28,-1.25,DEBIT_CARD,1176.26,
DEBIT,11/28/2016,FRED MEYE FRED MEYER 0 BELLINGHAM WA         11/26,-58.98,DEBIT_CARD,1177.51,
DEBIT,11/25/2016,ROBINHOOD (CRFN) ACH        2016112231567   WEB ID: 1000101344,-200,ACH_DEBIT,1236.49,
DEBIT,11/25/2016,STARBUCKS STORE 00332 EVERETT WA             11/24,-7.64,DEBIT_CARD,1436.49,
DEBIT,11/25/2016,CHEVRON 0211635 BELLINGHAM WA                11/24,-33.97,DEBIT_CARD,1444.13,
DEBIT,11/25/2016,SQ *LAKEWAY CHEVRON & D Bellingham WA        11/24,-4.78,DEBIT_CARD,1478.1,
DEBIT,11/25/2016,WA DRIVER LICENSE REN 360-902-7470 WA        11/24,-13,DEBIT_CARD,1482.88,
DEBIT,11/25/2016,ARAMARK TOPIOS BELLINGHAM WA                 11/22,-8.46,DEBIT_CARD,1495.88,
DEBIT,11/23/2016,USCONNECT ADVANTAGE VEN FERNDALE WA          11/23,-1.25,DEBIT_CARD,1504.34,
DEBIT,11/23/2016,USCONNECT ADVANTAGE VEN FERNDALE WA          11/23,-1.75,DEBIT_CARD,1505.59,
CREDIT,11/22/2016,KEY CR. TRANSFER ONLINE BK  000000013103946 WEB ID: 9000000008,1136.67,ACH_CREDIT,1507.34,
DEBIT,11/21/2016,APL* ITUNES.COM/BILL 866-712-7753 CA         11/20,-16.29,DEBIT_CARD,370.67,
DEBIT,11/21/2016,BOOMERS DRIVE IN BELLINGHAM WA               11/19,-12.99,DEBIT_CARD,386.96,
DEBIT,11/21/2016,STATE STREET BAR BELLINGHAM WA               11/19,-8.5,DEBIT_CARD,399.95,
DEBIT,11/21/2016,STATE STREET BAR BELLINGHAM WA               11/19,-9.75,DEBIT_CARD,408.45,
DEBIT,11/21/2016,USCONNECT ADVANTAGE VEN FERNDALE WA          11/19,-1.75,DEBIT_CARD,418.2,
DEBIT,11/18/2016,FAT PIE BELLINGHAM WA                        11/16,-8.89,DEBIT_CARD,419.95,
DEBIT,11/17/2016,RITE AID STORE - 5238 BELLINGHAM WA  282127  11/17,-4.89,DEBIT_CARD,428.84,
DEBIT,11/17/2016,RITE AID STORE - 5238 BELLINGHAM WA  184700  11/17,-17.51,DEBIT_CARD,433.73,
DEBIT,11/17/2016,WILD BUFFALO BELLINGHAM WA                   11/17,-5.35,DEBIT_CARD,451.24,
DEBIT,11/17/2016,SQ *MOUNT BAKERY FAIRHA Bellingham WA        11/16,-5.59,DEBIT_CARD,456.59,
DEBIT,11/17/2016,VENMO 855-812-4430 NY                        11/16,-13.5,DEBIT_CARD,462.18,
DEBIT,11/17/2016,VENMO 855-812-4430 NY                        11/16,-34,DEBIT_CARD,475.68,
DEBIT,11/17/2016,CASA QUE PASA BELLINGHAM WA                  11/15,-9.68,DEBIT_CARD,509.68,
DEBIT,11/17/2016,ARAMARK STARBUCKS BELLINGHAM WA              11/15,-5.98,DEBIT_CARD,519.36,
DEBIT,11/17/2016,ARAMARK ATRIUM POD BELLINGHAM WA             11/15,-1.72,DEBIT_CARD,525.34,
DEBIT,11/16/2016,SAN URBAN CRV T1W SAN DIEGO CA               11/15,-28.71,DEBIT_CARD,527.06,
DEBIT,11/16/2016,THE SHOUT HOUSE SAN DIEGO CA                 11/12,-16,DEBIT_CARD,555.77,
DEBIT,11/16/2016,THE SHOUT HOUSE SAN DIEGO CA                 11/12,-16.1,DEBIT_CARD,571.77,
DEBIT,11/16/2016,ARAMARK TOPIOS BELLINGHAM WA                 11/10,-7.37,DEBIT_CARD,587.87,
DEBIT,11/16/2016,ARAMARK STARBUCKS BELLINGHAM WA              11/10,-6.74,DEBIT_CARD,595.24,
DEBIT,11/15/2016,UBER   *US NOV14 HJVV 866-576-1039 CA        11/15,-10.56,DEBIT_CARD,601.98,
DEBIT,11/15/2016,SAN DIEGO CONV CTR CONC SAN DIEGO CA         11/14,-8.5,DEBIT_CARD,612.54,
DEBIT,11/15/2016,MRS FIELDS COOKIES SAN DIEGO CA              11/14,-7.5,DEBIT_CARD,621.04,
DEBIT,11/14/2016,NON-CHASE ATM FEE-WITH,-2.5,FEE_TRANSACTION,628.54,
DEBIT,11/14/2016,PAYPAL           INST XFER  5C2229WYERNK2   WEB ID: PAYPALSI77,-36,ACH_DEBIT,631.04,
DEBIT,11/14/2016,PAYPAL           INST XFER  5C2229WYESJTQ   WEB ID: PAYPALSI77,-36,ACH_DEBIT,667.04,
DEBIT,11/14/2016,INGRAM PUBL PRINCETON JACKSON TN     790457  11/14,-15.12,DEBIT_CARD,703.04,
DEBIT,11/14/2016,UBER   *US NOV13 44YT 866-576-1039 CA        11/14,-5.18,DEBIT_CARD,718.16,
DEBIT,11/14/2016,IN-N-OUT BURGER #123 SAN DIEGO CA            11/13,-7.51,DEBIT_CARD,723.34,
DEBIT,11/14/2016,UBER   *US NOV13 X6PR 866-576-1039 CA        11/14,-20.15,DEBIT_CARD,730.85,
DEBIT,11/14/2016,UBER   *US NOV13 XRJR 866-576-1039 CA        11/14,-17.19,DEBIT_CARD,751,
DEBIT,11/14/2016,UBER   *US NOV13 52ET 866-576-1039 CA        11/14,-5,DEBIT_CARD,768.19,
DEBIT,11/14/2016,UBER   *US NOV13 QAVN 866-576-1039 CA        11/14,-5,DEBIT_CARD,773.19,
DEBIT,11/14/2016,NON-CHASE ATM WITHDRAW               001571  11/131 PARK BL,-123.99,ATM,778.19,
DEBIT,11/14/2016,UBER   *US NOV12 5C35 866-576-1039 CA        11/13,-5.75,DEBIT_CARD,902.18,
DEBIT,11/14/2016,SAN DIEGO CONV CTR CONC SAN DIEGO CA         11/12,-2,DEBIT_CARD,907.93,
DEBIT,11/14/2016,UBER   *US NOV12 AFG4 866-576-1039 CA        11/12,-6.04,DEBIT_CARD,909.93,
DEBIT,11/14/2016,APL* ITUNES.COM/BILL 866-712-7753 CA         11/12,-5.42,DEBIT_CARD,915.97,
DEBIT,11/14/2016,MCKAYS TAPHOUSE BELLINGHAM WA                11/11,-5.75,DEBIT_CARD,921.39,
DEBIT,11/14/2016,HAGGEN FOOD #43 BELLINGHAM WA                11/11,-128.14,DEBIT_CARD,927.14,
DEBIT,11/14/2016,BOOMERS DRIVE IN BELLINGHAM WA               11/10,-6.71,DEBIT_CARD,1055.28,
DEBIT,11/14/2016,REGAL BARKLEY VILLAGE S BELLINGHAM WA        11/10,-3.9,DEBIT_CARD,1061.99,
DEBIT,11/14/2016,REGAL BARKLEY VILLAGE S BELLINGHAM WA        11/10,-18.66,DEBIT_CARD,1065.89,
DEBIT,11/14/2016,ARAMARK TONYS AT MILLER BELLINGHAM WA        11/08,-3.86,DEBIT_CARD,1084.55,
DEBIT,11/14/2016,APL* ITUNES.COM/BILL 866-712-7753 CA         11/11,-1.08,DEBIT_CARD,1088.41,
DEBIT,11/10/2016,PIZZA TIME BELLINGHAM WA                     11/08,-14.66,DEBIT_CARD,1089.49,
DEBIT,11/10/2016,ARAMARK MILLER MARKET P BELLINGHAM WA        11/08,-4.55,DEBIT_CARD,1104.15,
DEBIT,11/10/2016,ARAMARK FAIRHAVEN COMMO BELLINGHAM WA        11/07,-11.67,DEBIT_CARD,1108.7,
DEBIT,11/9/2016,COMMUNITY FOOD CO-OP - BELLINGHAM WA 630130  11/09,-11.15,DEBIT_CARD,1120.37,
DEBIT,11/9/2016,USCONNECT ADVANTAGE VEN FERNDALE WA          11/09,-1.75,DEBIT_CARD,1131.52,
DEBIT,11/9/2016,USCONNECT ADVANTAGE VEN FERNDALE WA          11/09,-1.75,DEBIT_CARD,1133.27,
DEBIT,11/9/2016,USCONNECT ADVANTAGE VEN FERNDALE WA          11/09,-1.75,DEBIT_CARD,1135.02,
DEBIT,11/9/2016,USCONNECT ADVANTAGE VEN FERNDALE WA          11/09,-1.75,DEBIT_CARD,1136.77,
DEBIT,11/8/2016,CASA QUE PASA BELLINGHAM WA                  11/07,-16.21,DEBIT_CARD,1138.52,
DEBIT,11/8/2016,ARAMARK ZOES BOOKSIDE B BELLINGHAM WA        11/06,-7.46,DEBIT_CARD,1154.73,
DEBIT,11/8/2016,VILLAGE BOOKS BELLINGHAM WA                  11/06,-17.38,DEBIT_CARD,1162.19,
DEBIT,11/7/2016,TRANSFER TO SAV XXXXX9660 11/07,-25,ACCT_XFER,1179.57,
DEBIT,11/7/2016,76 - STARVIN SAMS 14 BELLINGHAM WA           11/07,-39.58,DEBIT_CARD,1204.57,
DEBIT,11/7/2016,SOC FOR NEUROSCIENCE 202-962-4000 DC         11/05,-140,DEBIT_CARD,1244.15,
DEBIT,11/7/2016,SOC FOR NEUROSCIENCE 202-962-4000 DC         11/05,-30,DEBIT_CARD,1384.15,
DEBIT,11/7/2016,ARAMARK ZOES BOOKSIDE B BELLINGHAM WA        11/03,-3.89,DEBIT_CARD,1414.15,
DEBIT,11/4/2016,PAYPAL           INST XFER  HAYLEYGG689     WEB ID: PAYPALSI77,-45.27,ACH_DEBIT,1418.04,
DEBIT,11/4/2016,ARAMARK ATRIUM POD BELLINGHAM WA             11/02,-8.24,DEBIT_CARD,1463.31,
DEBIT,11/3/2016,HAGGEN FOOD #43 BELLINGHAM WA        257620  11/03,-16.82,DEBIT_CARD,1471.55,
DEBIT,11/3/2016,WWU AS BOOKSTORE BELLINGHAM WA               11/02,-8.97,DEBIT_CARD,1488.37,
DEBIT,11/3/2016,WWU EMARKETS 360-650-3720 WA                 11/02,-35,DEBIT_CARD,1497.34,
DEBIT,11/2/2016,HAGGEN FOOD #43 BELLINGHAM WA        750236  11/02,-3.58,DEBIT_CARD,1532.34,
DEBIT,11/2/2016,THE HORSESHOE CAFE BELLINGHAM WA             11/01,-9.2,DEBIT_CARD,1535.92,
DEBIT,11/2/2016,WILD BUFFALO BELLINGHAM WA                   10/31,-7.46,DEBIT_CARD,1545.12,
DEBIT,11/1/2016,PAYPAL           INST XFER  ESADINSKY       WEB ID: PAYPALSI77,-13.5,ACH_DEBIT,1552.58,
DEBIT,11/1/2016,Online Transfer to  SAV ...9660 transaction#: 5695836652,-50,ACCT_XFER,1566.08,
DEBIT,10/31/2016,JOHNNY'S GOURMET BURGER STANWOOD WA          10/30,-11.93,DEBIT_CARD,1616.08,
DEBIT,10/31/2016,UBER   *US OCT29 U22N 866-576-1039 CA        10/30,-15.08,DEBIT_CARD,1628.01,
DEBIT,10/31/2016,UBER   *US OCT29 GH5J 866-576-1039 CA        10/30,-25.44,DEBIT_CARD,1643.09,
DEBIT,10/31/2016,UBER   *US OCT29 AWMG 866-576-1039 CA        10/30,-5,DEBIT_CARD,1668.53,
DEBIT,10/31/2016,UBER   *US OCT29 FSSM 866-576-1039 CA        10/30,-9.57,DEBIT_CARD,1673.53,
DEBIT,10/31/2016,SQ *AUSTIN HODGKINSON Redmond WA             10/30,-30,DEBIT_CARD,1683.1,
DEBIT,10/31/2016,UBER   *US OCT29 UQ3Q 866-576-1039 CA        10/30,-5.18,DEBIT_CARD,1713.1,
DEBIT,10/31/2016,QUARTER LOUNGE SEATTLE WA                    10/29,-6.5,DEBIT_CARD,1718.28,
DEBIT,10/31/2016,BIG TIME BREWERY SEATTLE WA                  10/29,-5.93,DEBIT_CARD,1724.78,
DEBIT,10/31/2016,SEA SC PARKING #850012 SEATTLE WA            10/28,-10,DEBIT_CARD,1730.71,
DEBIT,10/31/2016,STARBUCKS STORE 23730 SEATTLE WA             10/28,-6.03,DEBIT_CARD,1740.71,
DEBIT,10/31/2016,76 - STARVIN SAMS 14 BELLINGHAM WA           10/28,-21.91,DEBIT_CARD,1746.74,
DEBIT,10/28/2016,STARVIN SAMS 14 BELLINGHAM WA        714050  10/28,-3.98,DEBIT_CARD,1768.65,
DEBIT,10/28/2016,BELLEWOOD ACRES INC LYNDEN WA                10/27,-6.77,DEBIT_CARD,1772.63,
DEBIT,10/28/2016,APL* ITUNES.COM/BILL 866-712-7753 CA         10/27,-1.09,DEBIT_CARD,1779.4,
DEBIT,10/28/2016,CASA QUE PASA BELLINGHAM WA                  10/26,-8.6,DEBIT_CARD,1780.49,
DEBIT,10/28/2016,WWU LIBRARY BELLINGHAM WA                    10/26,-18,DEBIT_CARD,1789.09,
DEBIT,10/28/2016,ARAMARK MILLER MARKET P BELLINGHAM WA        10/26,-1.29,DEBIT_CARD,1807.09,
DEBIT,10/28/2016,ARAMARK TONYS AT MILLER BELLINGHAM WA        10/26,-3.64,DEBIT_CARD,1808.38,
DEBIT,10/26/2016,PAYPAL           INST XFER  HAYLEYGG689     WEB ID: PAYPALSI77,-625.01,ACH_DEBIT,1812.02,
DEBIT,10/26/2016,USCONNECT ADVANTAGE VEN FERNDALE WA          10/26,-1.75,DEBIT_CARD,2437.03,
DEBIT,10/26/2016,USCONNECT ADVANTAGE VEN FERNDALE WA          10/26,-1.25,DEBIT_CARD,2438.78,
DEBIT,10/26/2016,PIZZA TIME BELLINGHAM WA                     10/24,-19.29,DEBIT_CARD,2440.03,
DSLIP,10/26/2016,DEPOSIT  ID NUMBER  71783,800,DEPOSIT,2459.32,
DEBIT,10/25/2016,USCONNECT ADVANTAGE VEN FERNDALE WA          10/25,-1.25,DEBIT_CARD,1659.32,
DEBIT,10/25/2016,USCONNECT ADVANTAGE VEN FERNDALE WA          10/25,-1.75,DEBIT_CARD,1660.57,
CREDIT,10/25/2016,KEY CR. TRANSFER ONLINE BK  000000013036971 WEB ID: 9000000008,1136.67,ACH_CREDIT,1662.32,
DEBIT,10/24/2016,PAYPAL           INST XFER  BLIZZARDENT     WEB ID: PAYPALSI77,-5.47,ACH_DEBIT,525.65,
DEBIT,10/24/2016,20TH CENTURY BOWLING BELLINGHAM WA           10/21,-10.5,DEBIT_CARD,531.12,
DEBIT,10/24/2016,20TH CENTURY BOWLING BELLINGHAM WA           10/21,-6,DEBIT_CARD,541.62,
DEBIT,10/24/2016,USCONNECT ADVANTAGE VEN FERNDALE WA          10/21,-1.75,DEBIT_CARD,547.62,
DEBIT,10/24/2016,USCONNECT ADVANTAGE VEN FERNDALE WA          10/21,-1.75,DEBIT_CARD,549.37,
DEBIT,10/24/2016,ARAMARK ZOES BOOKSIDE B BELLINGHAM WA        10/20,-4.83,DEBIT_CARD,551.12,
DEBIT,10/21/2016,ARAMARK ZOES BOOKSIDE B BELLINGHAM WA        10/19,-2.91,DEBIT_CARD,555.95,
DEBIT,10/21/2016,ARAMARK ZOES BOOKSIDE B BELLINGHAM WA        10/19,-12.87,DEBIT_CARD,558.86,
DEBIT,10/20/2016,HMD* Wired 800-769-4733 DE                   10/20,-5.44,DEBIT_CARD,571.73,
DEBIT,10/20/2016,APL* ITUNES.COM/BILL 866-712-7753 CA         10/19,-16.43,DEBIT_CARD,577.17,
DEBIT,10/20/2016,ARAMARK ZOES BOOKSIDE B BELLINGHAM WA        10/18,-2.76,DEBIT_CARD,593.6,
DEBIT,10/18/2016,ACT*City-Bellingham 877-228-4881 TX          10/18,-60,DEBIT_CARD,596.36,
DEBIT,10/18/2016,BLACKBIRD BAKERY BAINBRIDGE IS WA            10/16,-4.26,DEBIT_CARD,656.36,
DEBIT,10/17/2016,CHEVRON/SALMON SERVICE SEATTLE WA    048121  10/16,-32.86,DEBIT_CARD,660.62,
DEBIT,10/17/2016,USA*SODEXO SEATTLE WA                        10/15,-2.25,DEBIT_CARD,693.48,
DEBIT,10/17/2016,ARAMARK ATRIUM POD BELLINGHAM WA             10/11,-1.29,DEBIT_CARD,695.73,
DEBIT,10/17/2016,ARAMARK MILLER MARKET P BELLINGHAM WA        10/11,-1.63,DEBIT_CARD,697.02,
DEBIT,10/17/2016,ARAMARK TONYS AT MILLER BELLINGHAM WA        10/11,-3.86,DEBIT_CARD,698.65,
DEBIT,10/14/2016,BELLINGHAM GROC BELLINGHAM WA                10/14,-13.97,DEBIT_CARD,702.51,
DEBIT,10/14/2016,ARAMARK TOPIOS BELLINGHAM WA                 10/12,-7.37,DEBIT_CARD,716.48,
DEBIT,10/14/2016,ARAMARK TONYS AT MILLER BELLINGHAM WA        10/12,-3.86,DEBIT_CARD,723.85,
DEBIT,10/13/2016,WA DOL LIC & REG 60134 BELLINGHAM WA 832546  10/13,-11.25,DEBIT_CARD,727.71,
DEBIT,10/13/2016,APL* ITUNES.COM/BILL 866-712-7753 CA         10/13,-5.47,DEBIT_CARD,738.96,
DEBIT,10/11/2016,ARAMARK ZOES BOOKSIDE B BELLINGHAM WA        10/09,-5.59,DEBIT_CARD,744.43,
DEBIT,10/11/2016,ARAMARK ZOES BOOKSIDE B BELLINGHAM WA        10/09,-2.65,DEBIT_CARD,750.02,
DEBIT,10/11/2016,VILLAGE BOOKS BELLINGHAM WA                  10/08,-9.77,DEBIT_CARD,752.67,
DEBIT,10/11/2016,SQ *BOOK FARE CAFE Bellingham WA             10/08,-26.61,DEBIT_CARD,762.44,
DEBIT,10/11/2016,ACT*City-Bellingham 877-228-4881 TX          10/07,-90,DEBIT_CARD,789.05,
DEBIT,10/11/2016,WWU EMARKETS 360-650-3720 WA                 10/07,-35,DEBIT_CARD,879.05,
DEBIT,10/11/2016,ARAMARK TOPIOS BELLINGHAM WA                 10/06,-4.12,DEBIT_CARD,914.05,
DEBIT,10/7/2016,FRED MEYE FRED MEYER 0 BELLINGHAM WA         10/07,-5.99,DEBIT_CARD,918.17,
DEBIT,10/7/2016,SCHWEINHAUS BELLINGHAM WA                    10/05,-6.52,DEBIT_CARD,924.16,
DEBIT,10/7/2016,SCHWEINHAUS BELLINGHAM WA                    10/05,-8.88,DEBIT_CARD,930.68,
DEBIT,10/7/2016,SCHWEINHAUS BELLINGHAM WA                    10/05,-6.52,DEBIT_CARD,939.56,
CREDIT,10/7/2016,Online Transfer from SAV ...9660 transaction#: 5716406674,90,ACCT_XFER,946.08,
DEBIT,10/6/2016,TRANSFER TO SAV XXXXX9660 10/06,-25,ACCT_XFER,856.08,
DEBIT,10/4/2016,BOB'S BURGERS & BREW- BELLINGHAM WA          10/02,-13.8,DEBIT_CARD,881.08,
DEBIT,10/3/2016,D ANNAS CAFE ITALIANO BELLINGHAM WA          09/29,-20.82,DEBIT_CARD,894.88,
DEBIT,10/3/2016,ARAMARK TOPIOS BELLINGHAM WA                 09/29,-13.88,DEBIT_CARD,915.7,
DEBIT,9/30/2016,PAYPAL           INST XFER  HAYLEYGG689     WEB ID: PAYPALSI77,-37.04,ACH_DEBIT,929.58,
DEBIT,9/30/2016,PAYPAL           INST XFER  HAYLEYGG689     WEB ID: PAYPALSI77,-624.99,ACH_DEBIT,966.62,
DEBIT,9/30/2016,Online Transfer to  SAV ...9660 transaction#: 5632924236,-50,ACCT_XFER,1591.61,
DEBIT,9/30/2016,FRED MEYE FRED MEYER 0 BELLINGHAM WA         09/29,-119.95,DEBIT_CARD,1641.61,
DEBIT,9/30/2016,ARAMARK MILLER MARKET P BELLINGHAM WA        09/28,-9,DEBIT_CARD,1761.56,
DEBIT,9/29/2016,ARAMARK TONYS AT MILLER BELLINGHAM WA        09/27,-3.86,DEBIT_CARD,1770.56,
DEBIT,9/27/2016,SQC*JONATHAN FLYNN .  / CA                   09/26,-5,DEBIT_CARD,1774.42,
DEBIT,9/27/2016,ARAMARK ZOES BOOKSIDE B BELLINGHAM WA        09/26,-4.45,DEBIT_CARD,1779.42,
DEBIT,9/26/2016,SAMMYS PLACE BELLINGHAM WA                   09/24,-38.74,DEBIT_CARD,1783.87,
DEBIT,9/26/2016,APL* ITUNES.COM/BILL 866-712-7753 CA         09/23,-24.09,DEBIT_CARD,1822.61,
CREDIT,9/26/2016,KEY CR. TRANSFER ONLINE BK  000000012964102 WEB ID: 9000000008,1136.67,ACH_CREDIT,1846.7,
DEBIT,9/22/2016,PAYPAL           INST XFER  SLHOMEWORK      WEB ID: PAYPALSI77,-22.5,ACH_DEBIT,710.03,
DEBIT,9/20/2016,WWU EMARKETS 360-650-3720 WA                 09/19,-35,DEBIT_CARD,732.53,
DEBIT,9/19/2016,CASA QUE PASA BELLINGHAM WA                  09/17,-8.16,DEBIT_CARD,767.53,
DEBIT,9/19/2016,WALLY S BARBERSHOP BELLINGHAM WA             09/17,-23,DEBIT_CARD,775.69,
DEBIT,9/16/2016,PAYPAL           INST XFER  KIGOSAI         WEB ID: PAYPALSI77,-5,ACH_DEBIT,798.69,
DEBIT,9/16/2016,COLD TURKEY      IAT PAYPAL 1000021415082   WEB ID: 770510487C,-14.79,ACH_DEBIT,803.69,
DEBIT,9/16/2016,SQ *EL CAPITAN'S Bellingham WA               09/16,-8.25,DEBIT_CARD,818.48,
DEBIT,9/13/2016,BEST BUY #359 BELLINGHAM WA                  09/13,-227.71,DEBIT_CARD,826.73,
DEBIT,9/13/2016,APL* ITUNES.COM/BILL 866-712-7753 CA         09/13,-5.47,DEBIT_CARD,1054.44,
CREDIT,9/13/2016,PAYPAL           TRANSFER                   PPD ID: PAYPALSD11,33,ACH_CREDIT,1059.91,
DEBIT,9/12/2016,FRED MEYE FRED MEYER 0 BELLINGHAM WA         09/10,-18.46,DEBIT_CARD,1026.91,
DEBIT,9/12/2016,COMMUNITY FOOD CO-OP - BELLINGHAM WA 630610  09/10,-7.49,DEBIT_CARD,1045.37,
CREDIT,9/12/2016,Chase QuickPay Electronic Transfer 5654880468 from SUSAN K LOFTUS,15,QUICKPAY_CREDIT,1052.86,
DEBIT,9/9/2016,RADIOSHACK COR BELLINGHAM WA                 09/09,-21.73,DEBIT_CARD,1037.86,
DEBIT,9/9/2016,BEST BUY #359 BELLINGHAM WA                  09/09,-228.25,DEBIT_CARD,1059.59,
DEBIT,9/9/2016,FRED MEYE FRED MEYER 0 BELLINGHAM WA         09/08 Purchase $28.34 Cash Back $20.00,-48.34,DEBIT_CARD,1287.84,
DEBIT,9/8/2016,SQ *EL CAPITAN'S Bellingham WA               09/08,-9.25,DEBIT_CARD,1336.18,
DEBIT,9/8/2016,UW PARKING ONLINE 206-5434519 WA             09/07,-40,DEBIT_CARD,1345.43,
DEBIT,9/8/2016,STARBUCKS STORE 10990 SHORELINE WA           09/06,-11.83,DEBIT_CARD,1385.43,
DEBIT,9/7/2016,FRED MEYE FRED MEYER 0 BELLINGHAM WA         09/07,-69.05,DEBIT_CARD,1397.26,
DEBIT,9/7/2016,CHEEMA MARKET & SINGHS MCCLEARY WA           09/05,-35.97,DEBIT_CARD,1466.31,
DEBIT,9/6/2016,WA DOL LIC & REG 67414 SHORELINE WA  082158  09/06,-56,DEBIT_CARD,1502.28,
DEBIT,9/6/2016,WA DOL LIC & REG 67414 SHORELINE WA  577102  09/06,-66,DEBIT_CARD,1558.28,
DEBIT,9/6/2016,TRANSFER TO SAV XXXXX9660 09/06,-25,ACCT_XFER,1624.28,
DEBIT,9/6/2016,UW PARKING ONLINE 206-5434519 WA             09/05,-35,DEBIT_CARD,1649.28,
DEBIT,9/6/2016,MANZANITA GROCE 193 LA MANZANITA OR  524550  09/04,-29.85,DEBIT_CARD,1684.28,
DEBIT,9/6/2016,MANZANITA GROCE 193 LA MANZANITA OR  633429  09/04,-57.68,DEBIT_CARD,1714.13,
DEBIT,9/6/2016,FRONTIER ONBOARD DENVER CO                   09/04,-5.73,DEBIT_CARD,1771.81,
DEBIT,9/6/2016,BOOMERS DRIVE IN BELLINGHAM WA               09/01,-9.78,DEBIT_CARD,1777.54,
DEBIT,9/6/2016,DELL SALES & SERVICE 866-393-9460 TX         09/03,-876.05,DEBIT_CARD,1787.32,
DEBIT,9/6/2016,SOYLENT 8447695368 CA                        09/01,-48,DEBIT_CARD,2663.37,
DSLIP,9/6/2016,REMOTE ONLINE DEPOSIT #          1,110,CHECK_DEPOSIT,2711.37,1
DEBIT,9/2/2016,SHELL Service Station BELFAIR WA     970017  09/02,-1.79,DEBIT_CARD,2601.37,
DEBIT,9/2/2016,CHEVRON/CAR WASH ENT BAINBRIDGE IS WA005423  09/02,-31.9,DEBIT_CARD,2603.16,
DEBIT,9/1/2016,PAYPAL           INST XFER  HAYLEYGG689     WEB ID: PAYPALSI77,-250,ACH_DEBIT,2635.06,
DEBIT,9/1/2016,Online Transfer to  SAV ...9660 transaction#: 5564096484,-50,ACCT_XFER,2885.06,
DEBIT,9/1/2016,PIZZA TIME BELLINGHAM WA                     08/30,-23.1,DEBIT_CARD,2935.06,
CREDIT,9/1/2016,Online Transfer from SAV ...9660 transaction#: 5634621225,800,ACCT_XFER,2958.16,
DEBIT,8/31/2016,GOODMICO         IAT PAYPAL 1000006678890   WEB ID: 770510487C,-258,ACH_DEBIT,2158.16,
DEBIT,8/31/2016,801 UNIVERSITY KID SEATTLE WA                08/30,-13.01,DEBIT_CARD,2416.16,
DEBIT,8/30/2016,MCDONALD'S F13570 DENVER CO                  08/29,-9.18,DEBIT_CARD,2429.17,
DEBIT,8/30/2016,FRONTIER AI Q6Y32M DENVER CO                 08/29,-30,DEBIT_CARD,2438.35,
CREDIT,8/30/2016,Online Transfer from SAV ...9660 transaction#: 5626495605,258,ACCT_XFER,2468.35,
DEBIT,8/29/2016,UBER   *US AUG27 PAWO 866-576-1039 CA        08/28,-5,DEBIT_CARD,2210.35,
DEBIT,8/29/2016,SQ *AMORE GELATO Denver CO                   08/27,-4.85,DEBIT_CARD,2215.35,
DEBIT,8/29/2016,VIEWHOUSE II CENTENNIAL CO                   08/26,-33.85,DEBIT_CARD,2220.2,
CREDIT,8/29/2016,KEY CR. TRANSFER ONLINE BK  000000012843640 WEB ID: 9000000008,25,ACH_CREDIT,2254.05,
DEBIT,8/26/2016,KING SOOPERS 4910 YO GREENWOOD VIL CO931779  08/25,-2.99,DEBIT_CARD,2229.05,
DEBIT,8/26/2016,WM SUPERC Wal-Mart Sup AURORA (SE) CO        08/25,-11.09,DEBIT_CARD,2232.04,
DEBIT,8/26/2016,REGAL SOUTH GLEN STADIU CENTENNIAL CO        08/25,-22.18,DEBIT_CARD,2243.13,
DEBIT,8/26/2016,TOM'S URBAN 24 DIN DENVER CO                 08/25,-18.87,DEBIT_CARD,2265.31,
DEBIT,8/26/2016,WETZEL'S PRETZELS DENVER CO                  08/25,-4.31,DEBIT_CARD,2284.18,
DEBIT,8/26/2016,ALASKA AIR  02721218653 SEATTLE WA           08/23,-25,DEBIT_CARD,2288.49,
CREDIT,8/26/2016,INTERNAL DRIVE   DIRECT DEP                 PPD ID: 9111111101,1291.77,ACH_CREDIT,2313.49,
DEBIT,8/25/2016,Dropbox*WH6MT5B9G4ZZ db.tt/cchelp CA         08/24,-108.5,DEBIT_CARD,1021.72,
DEBIT,8/25/2016,PAYPAL           INST XFER  HAYLEYGG689     WEB ID: PAYPALSI77,-625,ACH_DEBIT,1130.22,
DEBIT,8/25/2016,GOGOAIR.COM 877-350-0038 IL                  08/24,-4.95,DEBIT_CARD,1755.22,
DEBIT,8/24/2016,HUDSONNEWS  ST597 SEATAC WA                  08/23,-6.78,DEBIT_CARD,1760.17,
DEBIT,8/24/2016,APL* ITUNES.COM/BILL 866-712-7753 CA         08/23,-16.43,DEBIT_CARD,1766.95,
CREDIT,8/24/2016,KEY CR. TRANSFER ONLINE BK  000000012828313 WEB ID: 9000000008,600,ACH_CREDIT,1783.38,
DEBIT,8/23/2016,WEBSHOP BOEGERSH IAT PAYPAL J2222289UZ5Z2   WEB ID: 770510487C,-38.1,ACH_DEBIT,1183.38,
DEBIT,8/22/2016,RITE AID STORE - 521 BAINBRIDGE IS WA255051  08/22,-17.14,DEBIT_CARD,1221.48,
DEBIT,8/22/2016,VILLAGE MUSIC AT LYN BAINBRIDGE IS WA        08/21,-28.21,DEBIT_CARD,1238.62,
DEBIT,8/22/2016,SAFEWAY  STORE  1252 BAINBRIDGE IS WA589949  08/20,-46.23,DEBIT_CARD,1266.83,
DEBIT,8/22/2016,SAFEWAY  STORE  1252 BAINBRIDGE IS WA717945  08/20,-11.95,DEBIT_CARD,1313.06,
DEBIT,8/22/2016,SUBI JAPANESE RESTAU BAINBRIDGE IS WA        08/20,-28.63,DEBIT_CARD,1325.01,
DEBIT,8/22/2016,BOEHMS CHOCOLATES POULSBO WA                 08/20,-9.06,DEBIT_CARD,1353.64,
DEBIT,8/22/2016,SQ *DANCING BRUSH POULS Poulsbo WA           08/20,-28.69,DEBIT_CARD,1362.7,
DEBIT,8/22/2016,CHEVRON 0373890 BAINBRIDGE IS WA             08/20,-30.55,DEBIT_CARD,1391.39,
DEBIT,8/22/2016,MADISON DINER BAINBRIDGE IS WA               08/20,-19.35,DEBIT_CARD,1421.94,
DEBIT,8/22/2016,UBER   *US AUG19 6XTS 866-576-1039 CA        08/20,-7.1,DEBIT_CARD,1441.29,
DEBIT,8/22/2016,UW FOOD SERVICES SEATTLE WA                  08/18,-8.88,DEBIT_CARD,1448.39,
DEBIT,8/22/2016,UW FOOD SERVICES SEATTLE WA                  08/18,-3.56,DEBIT_CARD,1457.27,
DEBIT,8/18/2016,SQ *COLLEGE INN EASYSHO Seattle WA           08/17,-2.59,DEBIT_CARD,1460.83,
DEBIT,8/18/2016,UW FOOD SERVICES SEATTLE WA                  08/16,-1.09,DEBIT_CARD,1463.42,
DEBIT,8/18/2016,UW FOOD SERVICES SEATTLE WA                  08/16,-3.56,DEBIT_CARD,1464.51,
DEBIT,8/17/2016,PAYPAL           INST XFER  BLIZZARDENT     WEB ID: PAYPALSI77,-11.91,ACH_DEBIT,1468.07,
DEBIT,8/17/2016,7-ELEVEN SEATTLE WA                          08/16,-1.19,DEBIT_CARD,1479.98,
DEBIT,8/16/2016,UNIVERSITY SMOKE SHOP SEATTLE WA             08/16,-8.16,DEBIT_CARD,1481.17,
DEBIT,8/16/2016,COSTAS RESTAURANT SEATTLE WA                 08/16,-46.61,DEBIT_CARD,1489.33,
DEBIT,8/16/2016,COLUMBIA CITY BAKERY RE SEATTLE WA           08/14,-17.18,DEBIT_CARD,1535.94,
DEBIT,8/15/2016,NON-CHASE ATM FEE-WITH,-2.5,FEE_TRANSACTION,1553.12,
DEBIT,8/15/2016,OFFICE DEPOT 00 4900 2 SEATTLE WA    518873  08/14,-17.51,DEBIT_CARD,1555.62,
DEBIT,8/15/2016,31 BARTELL DRUG SEATTLE WA                   08/14,-32.56,DEBIT_CARD,1573.13,
DEBIT,8/15/2016,WENDYS-SWL #4112 (1556) SEATTLE WA           08/14,-13.34,DEBIT_CARD,1605.69,
DEBIT,8/15/2016,NON-CHASE ATM WITHDRAW               459921  08/13417 NE 72,-23,ATM,1619.03,
DEBIT,8/15/2016,Online Transfer to SAV ...9660 transaction#: 5593502100 08/15,-517,ACCT_XFER,1642.03,
DEBIT,8/15/2016,SUBWAY        03357621 SEATTLE WA            08/13,-7.78,DEBIT_CARD,2159.03,
DEBIT,8/15/2016,SQ *BEAN AND BAGEL Seattle WA                08/12,-8.63,DEBIT_CARD,2166.81,
DEBIT,8/12/2016,SQ *COLLEGE INN EASYSHO Seattle WA           08/11,-1.99,DEBIT_CARD,2175.44,
DEBIT,8/12/2016,SQ *BEAN AND BAGEL Seattle WA                08/11,-3.05,DEBIT_CARD,2177.43,
DEBIT,8/12/2016,DIN TAI FUNG RESTA SEATTLE WA                08/10,-45.72,DEBIT_CARD,2180.48,
DEBIT,8/12/2016,FRAN'S CHOCOLATES - U V SEATTLE WA           08/10,-4,DEBIT_CARD,2226.2,
DEBIT,8/12/2016,FRAN'S CHOCOLATES - U V SEATTLE WA           08/10,-5.5,DEBIT_CARD,2230.2,
CREDIT,8/12/2016,INTERNAL DRIVE   DIRECT DEP                 PPD ID: 9111111101,1291.77,ACH_CREDIT,2235.7,
DEBIT,8/11/2016,UBER   *US AUG10 FX6F 866-576-1039 CA        08/11,-6.72,DEBIT_CARD,943.93,
DEBIT,8/11/2016,SQ *COLLEGE INN EASYSHO Seattle WA           08/10,-1.99,DEBIT_CARD,950.65,
DEBIT,8/11/2016,SQ *COLLEGE INN EASYSHO Seattle WA           08/10,-3.58,DEBIT_CARD,952.64,
DEBIT,8/11/2016,APL* ITUNES.COM/BILL 866-712-7753 CA         08/10,-5.47,DEBIT_CARD,956.22,
DEBIT,8/11/2016,ALASKA AIR  02778978447 SEATTLE WA           08/09,-95.1,DEBIT_CARD,961.69,
DEBIT,8/10/2016,SQ *COLLEGE INN EASYSHO Seattle WA           08/09,-2.99,DEBIT_CARD,1056.79,
DEBIT,8/10/2016,SEATTLE MUNI INT #950 180-095-0129 WA        08/09,-48,DEBIT_CARD,1059.78,
DEBIT,8/10/2016,SQ *BEAN AND BAGEL Seattle WA                08/09,-3.31,DEBIT_CARD,1107.78,
DEBIT,8/10/2016,FRONTIER AI Q6Y32M DENVER CO                 08/09,-75.1,DEBIT_CARD,1111.09,
DEBIT,8/10/2016,JUSTFLY.COM 800-717-5015 CT                  08/10,-9.95,DEBIT_CARD,1186.19,
DEBIT,8/9/2016,NON-CHASE ATM FEE-WITH,-2.5,FEE_TRANSACTION,1196.14,
DEBIT,8/9/2016,NON-CHASE ATM WITHDRAW               213451  08/08111 NE 45,-42.5,ATM,1198.64,
DEBIT,8/9/2016,APPLE STORE  #R072 SEATTLE WA                08/08,-108.5,DEBIT_CARD,1241.14,
DEBIT,8/9/2016,SQ *COLLEGE INN EASYSHO Seattle WA           08/08,-2.89,DEBIT_CARD,1349.64,
DEBIT,8/8/2016,TRANSFER TO SAV XXXXX9660 08/08,-25,ACCT_XFER,1352.53,
DEBIT,8/8/2016,GOLDBAR MARKET GOLDBAR WA                    08/07,-6.71,DEBIT_CARD,1377.53,
DEBIT,8/8/2016,GUSTAVS LEAVENWORTH WA                       08/07,-9.97,DEBIT_CARD,1384.24,
DEBIT,8/8/2016,DES SWEET SHOP LEAVENWORTH WA                08/06,-7.5,DEBIT_CARD,1394.21,
DEBIT,8/8/2016,IN *WOOD SHOP / HAT SH 509-5484442 WA        08/06,-17.34,DEBIT_CARD,1401.71,
DEBIT,8/8/2016,THE SKY DELI SKYKOMISH WA                    08/06,-11.31,DEBIT_CARD,1419.05,
DEBIT,8/8/2016,GOLDBAR MARKET GOLDBAR WA                    08/05,-6.47,DEBIT_CARD,1430.36,
DEBIT,8/8/2016,SAFEWAY  STORE  3091 SEATTLE WA      200771  08/05,-48.85,DEBIT_CARD,1436.83,
DEBIT,8/8/2016,AMAZON MKTPLACE PMTS AMZN.COM/BILL WA        08/05,-9.99,DEBIT_CARD,1485.68,
CREDIT,8/8/2016,Online Transfer from SAV ...9660 transaction#: 5580230508,400,ACCT_XFER,1495.67,
DEBIT,8/5/2016,SQ *COLLEGE INN EASYSHO Seattle WA           08/04,-6.08,DEBIT_CARD,1095.67,
DEBIT,8/4/2016,SQ *BEAN AND BAGEL Seattle WA                08/04,-5.61,DEBIT_CARD,1101.75,
DEBIT,8/4/2016,HOT MAMA'S PIZZA SEATTLE WA                  08/03,-7,DEBIT_CARD,1107.36,
DEBIT,8/4/2016,U BOOK STORE-U DISTRICT SEATTLE WA           08/03,-26.29,DEBIT_CARD,1114.36,
DEBIT,8/4/2016,U BOOK STORE-U DISTRICT SEATTLE WA           08/03,-5.03,DEBIT_CARD,1140.65,
DEBIT,8/4/2016,SQ *COLLEGE INN EASYSHO Seattle WA           08/03,-3.58,DEBIT_CARD,1145.68,
DEBIT,8/3/2016,Online Transfer to SAV ...9660 transaction#: 5571376955 08/03,-517,ACCT_XFER,1149.26,
DEBIT,8/3/2016,SQ *BEAN AND BAGEL Seattle WA                08/02,-11.74,DEBIT_CARD,1666.26,
DEBIT,8/3/2016,SWEET ALCHEMY ICE CREAM SEATTLE WA           08/01,-8.82,DEBIT_CARD,1678,
DEBIT,8/2/2016,UBER   *US AUG01 LH6E 866-576-1039 CA        08/02,-7.85,DEBIT_CARD,1686.82,
DEBIT,8/2/2016,APL* ITUNES.COM/BILL 866-712-7753 CA         08/02,-2.18,DEBIT_CARD,1694.67,
DEBIT,8/1/2016,Online Transfer to  SAV ...9660 transaction#: 5500132382,-50,ACCT_XFER,1696.85,
DEBIT,8/1/2016,BURGER AND KABOB HUT SEATTLE WA              07/31,-9.3,DEBIT_CARD,1746.85,
DEBIT,8/1/2016,BEN & JERRY'S DENVER CO                      07/31,-7.01,DEBIT_CARD,1756.15,
DEBIT,8/1/2016,FRONTIER AI GY9HXQ DENVER CO                 07/31,-40,DEBIT_CARD,1763.16,
DEBIT,8/1/2016,ADM/SHOP DENVER MUSEUM DENVER CO             07/30,-20,DEBIT_CARD,1803.16,
DEBIT,8/1/2016,PALLINO PASTARIA SEATAC SEATTLE WA           07/29,-13.59,DEBIT_CARD,1823.16,
DEBIT,8/1/2016,FRONTIER AI L3V7UV DENVER CO                 07/29,-40,DEBIT_CARD,1836.75,
CREDIT,7/29/2016,INTERNAL DRIVE   DIRECT DEP                 PPD ID: 9111111101,1291.77,ACH_CREDIT,1876.75,
DEBIT,7/27/2016,SQ *BEAN AND BAGEL Seattle WA                07/27,-7.9,DEBIT_CARD,584.98,
DEBIT,7/27/2016,SQ *BEAN AND BAGEL Seattle WA                07/26,-5.63,DEBIT_CARD,592.88,
DEBIT,7/26/2016,11 BARTELL DRUG SEATTLE WA                   07/26,-4.6,DEBIT_CARD,598.51,
DEBIT,7/26/2016,11 BARTELL DRUG SEATTLE WA                   07/26,-3.58,DEBIT_CARD,603.11,
DEBIT,7/26/2016,SQ *VASSILI PROD. LLC 877-417-4551 WA        07/26,-57.5,DEBIT_CARD,606.69,
DEBIT,7/26/2016,UBER   *US JUL25 R7FL 866-576-1039 CA        07/26,-8.1,DEBIT_CARD,664.19,
DEBIT,7/26/2016,THE HORSESHOE CAFE BELLINGHAM WA             07/25,-19.94,DEBIT_CARD,672.29,
DEBIT,7/25/2016,NON-CHASE ATM FEE-WITH,-2.5,FEE_TRANSACTION,692.23,
DEBIT,7/25/2016,FRONTIER AI GY9HXQ DENVER CO                 07/24,-183.1,DEBIT_CARD,694.73,
DEBIT,7/25/2016,FRONTIER AI L3V7UV DENVER CO                 07/24,-246.1,DEBIT_CARD,877.83,
DEBIT,7/25/2016,EXPEDIA*1141406320166 EXPEDIA.COM WA         07/24,-10,DEBIT_CARD,1123.93,
DEBIT,7/25/2016,NON-CHASE ATM WITHDRAW               002824  07/231200 11TH,-22.75,ATM,1133.93,
DEBIT,7/25/2016,CHEVRON/SALMON SERVICE SEATTLE WA    009962  07/23,-32.88,DEBIT_CARD,1156.68,
DEBIT,7/25/2016,CHEVRON/SALMON SERVICE SEATTLE WA    420670  07/23,-8.97,DEBIT_CARD,1189.56,
DEBIT,7/25/2016,THE SHOP HAIRCUTS LLC SEATTLE WA             07/24,-32,DEBIT_CARD,1198.53,
DEBIT,7/25/2016,APL* ITUNES.COM/BILL 866-712-7753 CA         07/23,-21.9,DEBIT_CARD,1230.53,
DEBIT,7/25/2016,SHULTZYS SAUSAGE INC SEATTLE WA              07/22,-35.86,DEBIT_CARD,1252.43,
DEBIT,7/22/2016,SQ *BEAN AND BAGEL Seattle WA                07/21,-2.52,DEBIT_CARD,1288.29,
DEBIT,7/21/2016,SQ *BEAN AND BAGEL Seattle WA                07/21,-7.57,DEBIT_CARD,1290.81,
DEBIT,7/21/2016,FET SERVICES INC. 561-2021973 FL             07/20,-30,DEBIT_CARD,1298.38,
DEBIT,7/19/2016,CHIPOTLE 0578 SEATTLE WA                     07/18,-10.19,DEBIT_CARD,1328.38,
DEBIT,7/19/2016,MCDONALD'S F1697 SEATTLE WA                  07/17,-9.32,DEBIT_CARD,1338.57,
DEBIT,7/18/2016,Online Transfer to SAV ...9660 transaction#: 5535509840 07/18,-517,ACCT_XFER,1347.89,
DEBIT,7/18/2016,SQ *BEAN AND BAGEL Seattle WA                07/18,-8.45,DEBIT_CARD,1864.89,
DEBIT,7/18/2016,SQ *A JUKE JOINT PRODUC Seattle WA           07/18,-7.25,DEBIT_CARD,1873.34,
DEBIT,7/18/2016,801 UNIVERSITY KID SEATTLE WA                07/17,-10.06,DEBIT_CARD,1880.59,
DEBIT,7/18/2016,A PIZZA MART SEATTLE WA                      07/17,-9.6,DEBIT_CARD,1890.65,
DEBIT,7/18/2016,U BOOK STORE-U DISTRICT SEATTLE WA           07/15,-7.56,DEBIT_CARD,1900.25,
CREDIT,7/15/2016,INTERNAL DRIVE   DIRECT DEP                 PPD ID: 9111111101,1291.77,ACH_CREDIT,1907.81,
DEBIT,7/14/2016,UW FOOD SERVICES SEATTLE WA                  07/12,-1.73,DEBIT_CARD,616.04,
DEBIT,7/13/2016,UW FOOD SERVICES SEATTLE WA                  07/11,-2.35,DEBIT_CARD,617.77,
DEBIT,7/12/2016,SQ *BEAN AND BAGEL Seattle WA                07/12,-9.36,DEBIT_CARD,620.12,
DEBIT,7/12/2016,SQ *COLLEGE INN EASYSHO Seattle WA           07/11,-1.29,DEBIT_CARD,629.48,
DEBIT,7/12/2016,PORTAGE BAY CAFE AND CA SEATTLE WA           07/10,-21.73,DEBIT_CARD,630.77,
DEBIT,7/12/2016,"THE TRADING MUSICAN, IN SEATTLE WA           07/10",-31.24,DEBIT_CARD,652.5,
DEBIT,7/11/2016,NON-CHASE ATM FEE-WITH,-2.5,FEE_TRANSACTION,683.74,
DEBIT,7/11/2016,NON-CHASE ATM WITHDRAW               957994  07/09417 NE 72,-23,ATM,686.24,
DEBIT,7/11/2016,UW PARKING ONLINE 206-5434519 WA             07/09,-35,DEBIT_CARD,709.24,
DEBIT,7/11/2016,NORDSTROM#1 SEATTLE WA                       07/09,-117.27,DEBIT_CARD,744.24,
DEBIT,7/11/2016,31 BARTELL DRUG SEATTLE WA                   07/09,-9.51,DEBIT_CARD,861.51,
DEBIT,7/11/2016,UBER   *US JUL08 RTR5 866-576-1039 CA        07/09,-6.35,DEBIT_CARD,871.02,
DEBIT,7/11/2016,DOMINO'S 7084 503-689-1288 WA                07/09,-20.93,DEBIT_CARD,877.37,
DEBIT,7/11/2016,APL* ITUNES.COM/BILL 866-712-7753 CA         07/09,-5.47,DEBIT_CARD,898.3,
DEBIT,7/8/2016,UW FOOD SERVICES SEATTLE WA                  07/06,-14.33,DEBIT_CARD,903.77,
DEBIT,7/7/2016,DRI*RAZER orderfind.com MN                   07/06,-87.67,DEBIT_CARD,918.1,
DEBIT,7/6/2016,TRANSFER TO SAV XXXXX9660 07/06,-25,ACCT_XFER,1005.77,
DEBIT,7/6/2016,U BOOK STORE-U DISTRICT SEATTLE WA           07/05,-14.34,DEBIT_CARD,1030.77,
DEBIT,7/6/2016,ALADDIN GYRO RESTAURANT SEATTLE WA           07/04,-14,DEBIT_CARD,1045.11,
DEBIT,7/5/2016,NON-CHASE ATM FEE-WITH,-2.5,FEE_TRANSACTION,1059.11,
DEBIT,7/5/2016,NON-CHASE ATM WITHDRAW               324424  07/04HARRISON,-23.95,ATM,1061.61,
DEBIT,7/5/2016,801 UNIVERSITY KID SEATTLE WA                07/02,-13.01,DEBIT_CARD,1085.56,
DEBIT,7/5/2016,Online Transfer to SAV ...9660 transaction#: 5502339876 07/05,-430,ACCT_XFER,1098.57,
DEBIT,7/5/2016,METROPOLI 3830 34TH WE SEATTLE WA            07/01,-27.13,DEBIT_CARD,1528.57,
DEBIT,7/5/2016,UW FOOD SERVICES SEATTLE WA                  07/01,-0.96,DEBIT_CARD,1555.7,
DEBIT,7/5/2016,Amazon.com AMZN.COM/BILL WA                  07/01,-28.15,DEBIT_CARD,1556.66,
DEBIT,7/1/2016,PAYPAL           INST XFER  HAYLEYGG689     WEB ID: PAYPALSI77,-25,ACH_DEBIT,1584.81,
DEBIT,7/1/2016,Online Transfer to  SAV ...9660 transaction#: 5431155138,-50,ACCT_XFER,1609.81,
DEBIT,7/1/2016,UW FOOD SERVICES SEATTLE WA                  06/29,-3.21,DEBIT_CARD,1659.81,
CREDIT,7/1/2016,INTERNAL DRIVE   DIRECT DEP                 PPD ID: 9111111101,1075.19,ACH_CREDIT,1663.02,
DEBIT,6/30/2016,Amazon Video On Dema AMZN.COM/bill WA        06/30,-4.34,DEBIT_CARD,587.83,
DEBIT,6/29/2016,SQ *BEAN AND BAGEL Seattle WA                06/29,-3.05,DEBIT_CARD,592.17,
DEBIT,6/28/2016,SQ *BEAN AND BAGEL Seattle WA                06/28,-8.45,DEBIT_CARD,595.22,
DEBIT,6/27/2016,"CHEVRON/WASU, INC SEATTLE WA         016643  06/27",-2.95,DEBIT_CARD,603.67,
DEBIT,6/27/2016,SAFEWAY  STORE  3091 SEATTLE WA      174995  06/27,-3.99,DEBIT_CARD,606.62,
DEBIT,6/27/2016,CHIPOTLE 0578 SEATTLE WA                     06/26,-10.19,DEBIT_CARD,610.61,
DEBIT,6/27/2016,Seattle Team Shop Stor SEATTLE WA    988618  06/25,-28.5,DEBIT_CARD,620.8,
DEBIT,6/27/2016,SHELL Service Station BELLINGHAM WA  017424  06/25,-34.35,DEBIT_CARD,649.3,
DEBIT,6/27/2016,SHELL Service Station BELLINGHAM WA  601141  06/25,-7.77,DEBIT_CARD,683.65,
DEBIT,6/27/2016,PIZZA TIME BELLINGHAM WA                     06/25,-16,DEBIT_CARD,691.42,
DEBIT,6/27/2016,ALADDIN GYRO RESTAURANT SEATTLE WA           06/24,-12.5,DEBIT_CARD,707.42,
CREDIT,6/27/2016,PAYPAL           TRANSFER                   PPD ID: PAYPALSD11,7.5,ACH_CREDIT,719.92,
DEBIT,6/24/2016,PAYPAL           INST XFER  5C2229PM9VSRA   WEB ID: PAYPALSI77,-10,ACH_DEBIT,712.42,
DEBIT,6/23/2016,SQ *BEAN AND BAGEL Seattle WA                06/22,-7.95,DEBIT_CARD,722.42,
DEBIT,6/23/2016,SWEET ALCHEMY ICE CREAM SEATTLE WA           06/21,-11.34,DEBIT_CARD,730.37,
DEBIT,6/21/2016,SHAYWARMA KING SEATTLE WA                    06/21,-13.03,DEBIT_CARD,741.71,
DEBIT,6/21/2016,SQ *BEAN AND BAGEL Seattle WA                06/20,-7.95,DEBIT_CARD,754.74,
DEBIT,6/20/2016,MOD PIZZA U DISTRICT 3 SEATTLE WA            06/18,-3.21,DEBIT_CARD,762.69,
DEBIT,6/20/2016,SQ *CAFE YUNNIE Seattle WA                   06/17,-6.21,DEBIT_CARD,765.9,
DEBIT,6/20/2016,UW FOOD SERVICES SEATTLE WA                  06/17,-4.94,DEBIT_CARD,772.11,
DEBIT,6/17/2016,SQ *BEAN AND BAGEL Seattle WA                06/16,-2.9,DEBIT_CARD,777.05,
CREDIT,6/17/2016,PAYPAL           TRANSFER                   PPD ID: PAYPALSD11,125,ACH_CREDIT,779.95,
DEBIT,6/16/2016,PAYPAL           INST XFER  HAYLEYGG689     WEB ID: PAYPALSI77,-74.42,ACH_DEBIT,654.95,
DEBIT,6/16/2016,SEATTLE MUNI INT #950 180-095-0129 WA        06/15,-48,DEBIT_CARD,729.37,
DEBIT,6/15/2016,SQ *SOUND COFFEE AND MO Seattle WA           06/14,-11.79,DEBIT_CARD,777.37,
DEBIT,6/15/2016,REPUBLIC PARKING 30 562 SEATTLE WA           06/14,-12,DEBIT_CARD,789.16,
DEBIT,6/14/2016,CHEVRON 0211635 BELLINGHAM WA                06/13,-28.58,DEBIT_CARD,801.16,
DEBIT,6/14/2016,SQ *LAKEWAY CHEVRON & D Bellingham WA        06/13,-6.63,DEBIT_CARD,829.74,
DEBIT,6/13/2016,NON-CHASE ATM FEE-WITH,-2.5,FEE_TRANSACTION,836.37,
DEBIT,6/13/2016,JIFFY LUBE #2081 BELLINGHAM WA       823266  06/13,-143.44,DEBIT_CARD,838.87,
DEBIT,6/13/2016,NON-CHASE ATM WITHDRAW               006045  06/131319 RAIL,-21.9,ATM,982.31,
DEBIT,6/13/2016,WHOLEFDS BLW#10 1030 L BELLINGHAM WA 625828  06/12,-36.81,DEBIT_CARD,1004.21,
DEBIT,6/13/2016,APL* ITUNES.COM/BILL 866-712-7753 CA         06/13,-5.47,DEBIT_CARD,1041.02,
DEBIT,6/13/2016,MMUNITY FOOD CO-OP - N BELLINGHAM WA 094531  06/11,-3.49,DEBIT_CARD,1046.49,
DEBIT,6/13/2016,WHOLEFDS BLW#10 1030 L BELLINGHAM WA 715430  06/11,-37.09,DEBIT_CARD,1049.98,
DEBIT,6/13/2016,WESTSIDE TCBY BELLINGHAM WA                  06/11,-5.44,DEBIT_CARD,1087.07,
DEBIT,6/13/2016,TARGET T- 30 Bellis Fa Bellingham WA         06/10,-4.44,DEBIT_CARD,1092.51,
DEBIT,6/13/2016,AEROPOSTALE #535 BELLINGHAM WA               06/10,-17.17,DEBIT_CARD,1096.95,
DEBIT,6/13/2016,H&M #348 BELLIS FAIR MA BELLINGHAM WA        06/10,-10.86,DEBIT_CARD,1114.12,
DEBIT,6/13/2016,CAR WASH KING BELLINGHAM WA                  06/10,-15,DEBIT_CARD,1124.98,
DEBIT,6/13/2016,PEACEHEALTH LABORATORI SPRINGFIELD OR        06/10,-42.54,DEBIT_CARD,1139.98,
DEBIT,6/13/2016,BOOMERS DRIVE IN BELLINGHAM WA               06/09,-12.73,DEBIT_CARD,1182.52,
CREDIT,6/13/2016,KEY CR. TRANSFER ONLINE BK  000000012422860 WEB ID: 9000000008,42.54,ACH_CREDIT,1195.25,
DEBIT,6/10/2016,MACY'S    50 BELLIS FA BELLINGHAM WA         06/10,-113.03,DEBIT_CARD,1152.71,
DEBIT,6/10/2016,ARAMARK MILLER MARKET P BELLINGHAM WA        06/08,-0.97,DEBIT_CARD,1265.74,
DEBIT,6/10/2016,ARAMARK TONYS AT MILLER BELLINGHAM WA        06/08,-3.53,DEBIT_CARD,1266.71,
DSLIP,6/10/2016,REMOTE ONLINE DEPOSIT #          1,200,CHECK_DEPOSIT,1270.24,1
DEBIT,6/9/2016,SQ *JJ'S IN AND OUT GOS Bellingham WA        06/09,-13.02,DEBIT_CARD,1070.24,
DEBIT,6/9/2016,SQ *EL CAPITAN'S Bellingham WA               06/09,-6.75,DEBIT_CARD,1083.26,
DEBIT,6/9/2016,HAGGEN FOOD #43 BELLINGHAM WA        231116  06/08,-5.85,DEBIT_CARD,1090.01,
DEBIT,6/9/2016,ARAMARK VIKING UNION MA BELLINGHAM WA        06/07,-2.71,DEBIT_CARD,1095.86,
DEBIT,6/8/2016,FRED MEYE FRED MEYER 0 BELLINGHAM WA         06/08,-24.99,DEBIT_CARD,1098.57,
DEBIT,6/8/2016,SQ *QQ LI'S CHINESE CUI Bellingham WA        06/07,-10.5,DEBIT_CARD,1123.56,
DEBIT,6/8/2016,WWU PARKING PAYBOXES BELLINGHAM WA           06/07,-8,DEBIT_CARD,1134.06,
DEBIT,6/6/2016,TRANSFER TO SAV XXXXX9660 06/06,-25,ACCT_XFER,1142.06,
DEBIT,6/6/2016,FRED MEYER FRED MEYER BELLINGHAM WA  955821  06/05,-3.79,DEBIT_CARD,1167.06,
DEBIT,6/6/2016,ARAMARK ZOES BOOKSIDE B BELLINGHAM WA        06/03,-3.79,DEBIT_CARD,1170.85,
DEBIT,6/6/2016,ARAMARK TONYS AT MILLER BELLINGHAM WA        06/02,-3.75,DEBIT_CARD,1174.64,
DEBIT,6/6/2016,ARAMARK MILLER MARKET P BELLINGHAM WA        06/02,-2.45,DEBIT_CARD,1178.39,
DEBIT,6/3/2016,ARAMARK ZOES BOOKSIDE B BELLINGHAM WA        06/02,-3.02,DEBIT_CARD,1180.84,
DEBIT,6/3/2016,ARAMARK ATRIUM POD BELLINGHAM WA             06/01,-4.34,DEBIT_CARD,1183.86,
CREDIT,6/3/2016,INTERNAL DRIVE   DIRECT DEP                 PPD ID: 9111111101,347.99,ACH_CREDIT,1188.2,
DEBIT,6/2/2016,FRED MEYER FRED MEYER BELLINGHAM WA  664436  06/01,-71.41,DEBIT_CARD,840.21,
DEBIT,6/2/2016,ARAMARK TOPIOS BELLINGHAM WA                 05/31,-8.41,DEBIT_CARD,911.62,
DEBIT,6/2/2016,ARAMARK MILLER MARKET P BELLINGHAM WA        05/31,-4.87,DEBIT_CARD,920.03,
DEBIT,6/1/2016,Online Transfer to  SAV ...9660 transaction#: 5359671690,-50,ACCT_XFER,924.9,
DEBIT,6/1/2016,BOOMERS DRIVE IN BELLINGHAM WA               05/30,-9.58,DEBIT_CARD,974.9,
DEBIT,6/1/2016,WWU EMARKETS 360-650-3720 WA                 05/31,-33,DEBIT_CARD,984.48,
DEBIT,5/31/2016,ARAMARK ZOES BOOKSIDE B BELLINGHAM WA        05/30,-8.52,DEBIT_CARD,1017.48,
DEBIT,5/31/2016,FRED MEYER FRED MEYER BELLINGHAM WA  022824  05/29,-36.14,DEBIT_CARD,1026,
DEBIT,5/31/2016,FRED MEYER FRED MEYER BELLINGHAM WA  140510  05/28,-14.28,DEBIT_CARD,1062.14,
DEBIT,5/31/2016,SQ *EL CAPITAN'S Bellingham WA               05/28,-9,DEBIT_CARD,1076.42,
DEBIT,5/31/2016,REGAL BARKLEY VILLAGE S BELLINGHAM WA        05/28,-15.46,DEBIT_CARD,1085.42,
DEBIT,5/31/2016,WWU AS BOOKSTORE BELLINGHAM WA               05/27,-3.44,DEBIT_CARD,1100.88,
DEBIT,5/31/2016,ARAMARK ATRIUM POD BELLINGHAM WA             05/26,-2.15,DEBIT_CARD,1104.32,
DEBIT,5/27/2016,PAYPAL           INST XFER  HAYLEYGG689     WEB ID: PAYPALSI77,-600,ACH_DEBIT,1106.47,
DEBIT,5/27/2016,RITE AID STORE - 5238 BELLINGHAM WA  057267  05/27,-4.26,DEBIT_CARD,1706.47,
DEBIT,5/26/2016,ARAMARK ZOES BOOKSIDE B BELLINGHAM WA        05/25,-1.29,DEBIT_CARD,1710.73,
DEBIT,5/26/2016,ARAMARK ATRIUM POD BELLINGHAM WA             05/24,-2.27,DEBIT_CARD,1712.02,
DEBIT,5/25/2016,ARAMARK ZOES BOOKSIDE B BELLINGHAM WA        05/24,-3.3,DEBIT_CARD,1714.29,
DEBIT,5/24/2016,ARAMARK ZOES BOOKSIDE B BELLINGHAM WA        05/23,-4.99,DEBIT_CARD,1717.59,
DEBIT,5/24/2016,76 00399196 BELLINGHAM WA                    05/23,-23.54,DEBIT_CARD,1722.58,
CREDIT,5/24/2016,KEY CR. TRANSFER ONLINE BK  000000012318455 WEB ID: 9000000008,1111.67,ACH_CREDIT,1746.12,
DEBIT,5/23/2016,STIA PUBLIC PARKING SEATAC WA                05/22,-68,DEBIT_CARD,634.45,
DEBIT,5/23/2016,SILVER DRAGON CAFE OAKLAND CA                05/22,-15.08,DEBIT_CARD,702.45,
DEBIT,5/23/2016,UBER   *MAY22 US LRTJ 866-576-1039 CA        05/23,-17.86,DEBIT_CARD,717.53,
DEBIT,5/23/2016,UBER   *MAY21 US 2EV6 866-576-1039 CA        05/22,-4.85,DEBIT_CARD,735.39,
DEBIT,5/23/2016,IN-N-OUT BURGER #303 ALAMEDA CA              05/21,-11.11,DEBIT_CARD,740.24,
DEBIT,5/23/2016,UBER   *MAY21 US ES6R 866-576-1039 CA        05/22,-4.46,DEBIT_CARD,751.35,
DEBIT,5/23/2016,UBER   *MAY21 US 5NAM 866-576-1039 CA        05/21,-16.55,DEBIT_CARD,755.81,
DEBIT,5/23/2016,QDOBA MEXICAN GRILL-170 SEATTLE WA           05/20,-12.92,DEBIT_CARD,772.36,
DEBIT,5/23/2016,76 00399196 BELLINGHAM WA                    05/20,-12.08,DEBIT_CARD,785.28,
DEBIT,5/23/2016,ARAMARK ZOES BOOKSIDE B BELLINGHAM WA        05/20,-4.55,DEBIT_CARD,797.36,
DEBIT,5/23/2016,ARAMARK MILLER MARKET P BELLINGHAM WA        05/20,-4.45,DEBIT_CARD,801.91,
DEBIT,5/23/2016,Amazon.com AMZN.COM/BILL WA                  05/21,-8.29,DEBIT_CARD,806.36,
DEBIT,5/23/2016,ARAMARK TOPIOS BELLINGHAM WA                 05/19,-4.34,DEBIT_CARD,814.65,
DEBIT,5/20/2016,ARAMARK ZOES BOOKSIDE B BELLINGHAM WA        05/19,-4.34,DEBIT_CARD,818.99,
DEBIT,5/20/2016,PIZZA TIME BELLINGHAM WA                     05/19,-18,DEBIT_CARD,823.33,
DEBIT,5/19/2016,NON-CHASE ATM FEE-WITH,-2.5,FEE_TRANSACTION,841.33,
DEBIT,5/19/2016,PAYPAL           INST XFER  HAYLEYGG689     WEB ID: PAYPALSI77,-38.62,ACH_DEBIT,843.83,
DEBIT,5/19/2016,NON-CHASE ATM WITHDRAW               291848  05/19516 HIGH,-25,ATM,882.45,
DEBIT,5/19/2016,WALLY S BARBERSHOP BELLINGHAM WA             05/18,-24,DEBIT_CARD,907.45,
DEBIT,5/18/2016,WWU EMARKETS 360-650-3720 WA                 05/17,-33,DEBIT_CARD,931.45,
DEBIT,5/18/2016,ARAMARK TOPIOS BELLINGHAM WA                 05/16,-7.76,DEBIT_CARD,964.45,
DEBIT,5/16/2016,ARAMARK ZOES BOOKSIDE B BELLINGHAM WA        05/15,-7.33,DEBIT_CARD,972.21,
DEBIT,5/16/2016,ARAMARK ZOES BOOKSIDE B BELLINGHAM WA        05/13,-4.45,DEBIT_CARD,979.54,
DEBIT,5/16/2016,ARAMARK TOPIOS BELLINGHAM WA                 05/12,-4.12,DEBIT_CARD,983.99,
CREDIT,5/16/2016,Chase QuickPay Electronic Transfer 5390872320 from SUSAN K LOFTUS,100,QUICKPAY_CREDIT,988.11,
DEBIT,5/13/2016,WWU EMARKETS 360-650-3720 WA                 05/12,-33,DEBIT_CARD,888.11,
DEBIT,5/13/2016,APL* ITUNES.COM/BILL 866-712-7753 CA         05/13,-5.47,DEBIT_CARD,921.11,
DEBIT,5/13/2016,TACO TIME SAMISH BELLINGHAM WA               05/11,-9.67,DEBIT_CARD,926.58,
DEBIT,5/13/2016,ARAMARK MILLER MARKET P BELLINGHAM WA        05/11,-6.24,DEBIT_CARD,936.25,
DEBIT,5/12/2016,ARAMARK ATRIUM POD BELLINGHAM WA             05/10,-4.55,DEBIT_CARD,942.49,
DEBIT,5/10/2016,ALASKA AIR  02777941605 SEATTLE WA           05/08,-428.2,DEBIT_CARD,947.04,
DEBIT,5/9/2016,PAYPAL           INST XFER  FANDANGO        WEB ID: PAYPALSI77,-13.35,ACH_DEBIT,1375.24,
DEBIT,5/9/2016,FRED MEYER FRED MEYER BELLINGHAM WA  661052  05/08,-94.76,DEBIT_CARD,1388.59,
DEBIT,5/9/2016,AB CREPES BELLINGHAM WA                      05/08,-8.65,DEBIT_CARD,1483.35,
DEBIT,5/9/2016,REGAL BARKLEY VILLAGE S BELLINGHAM WA        05/08,-16.6,DEBIT_CARD,1492,
DEBIT,5/9/2016,REGAL BARKLEY VILLAGE S BELLINGHAM WA        05/08,-12,DEBIT_CARD,1508.6,
DEBIT,5/9/2016,STARBUCKS #03290 BELLIN Bellingham WA        05/07,-10.82,DEBIT_CARD,1520.6,
DEBIT,5/9/2016,USCONNECT ADVANTAGE VEN FERNDALE WA          05/08,-1.25,DEBIT_CARD,1531.42,
DEBIT,5/9/2016,USCONNECT ADVANTAGE VEN FERNDALE WA          05/08,-1.75,DEBIT_CARD,1532.67,
DEBIT,5/9/2016,PIZZA TIME BELLINGHAM WA                     05/07,-20.56,DEBIT_CARD,1534.42,
DEBIT,5/9/2016,REGAL BARKLEY VILLAGE S BELLINGHAM WA        05/07,-17.36,DEBIT_CARD,1554.98,
DEBIT,5/9/2016,ARAMARK TOPIOS BELLINGHAM WA                 05/06,-6.29,DEBIT_CARD,1572.34,
DEBIT,5/9/2016,ARAMARK PANDA EXPRESS BELLINGHAM WA          05/05,-6.59,DEBIT_CARD,1578.63,
CREDIT,5/9/2016,Online Transfer from SAV ...9660 transaction#: 5381861217,428.2,ACCT_XFER,1585.22,
DEBIT,5/6/2016,TRANSFER TO SAV XXXXX9660 05/06,-25,ACCT_XFER,1157.02,
DEBIT,5/5/2016,ARAMARK ATRIUM POD BELLINGHAM WA             05/03,-7.48,DEBIT_CARD,1182.02,
DEBIT,5/5/2016,ARAMARK ATRIUM POD BELLINGHAM WA             05/03,-5.63,DEBIT_CARD,1189.5,
DEBIT,5/4/2016,CHEVRON 0094948 BELLINGHAM WA                05/04,-37.89,DEBIT_CARD,1195.13,
DEBIT,5/2/2016,WWU AS BOOKSTORE BELLINGHAM WA               04/30,-13.26,DEBIT_CARD,1233.02,
DEBIT,5/2/2016,ARAMARK ATRIUM POD BELLINGHAM WA             04/29,-3.57,DEBIT_CARD,1246.28,
DEBIT,5/2/2016,ARAMARK TOPIOS BELLINGHAM WA                 04/28,-7.37,DEBIT_CARD,1249.85,
DEBIT,4/29/2016,Online Transfer to  SAV ...9660 transaction#: 5298577312,-50,ACCT_XFER,1257.22,
DEBIT,4/29/2016,ARAMARK ATRIUM POD BELLINGHAM WA             04/27,-3.45,DEBIT_CARD,1307.22,
DEBIT,4/26/2016,WWU LIBRARY BELLINGHAM WA                    04/24,-10,DEBIT_CARD,1310.67,
DEBIT,4/25/2016,PAYPAL           INST XFER  HAYLEYGG689     WEB ID: PAYPALSI77,-55.18,ACH_DEBIT,1320.67,
DEBIT,4/25/2016,PAYPAL           INST XFER  NEKOKIN         WEB ID: PAYPALSI77,-625,ACH_DEBIT,1375.85,
DEBIT,4/25/2016,FRED MEYER FRED MEYER BELLINGHAM WA  807377  04/24,-45.39,DEBIT_CARD,2000.85,
DEBIT,4/25/2016,ARAMARK ATRIUM POD BELLINGHAM WA             04/22,-6.27,DEBIT_CARD,2046.24,
DEBIT,4/25/2016,USCONNECT ADVANTAGE VEN FERNDALE WA          04/23,-1.75,DEBIT_CARD,2052.51,
DEBIT,4/25/2016,ARAMARK TOPIOS BELLINGHAM WA                 04/21,-4.12,DEBIT_CARD,2054.26,
CREDIT,4/25/2016,KEY CR. TRANSFER ONLINE BK  000000012147218 WEB ID: 9000000008,1111.67,ACH_CREDIT,2058.38,
DEBIT,4/22/2016,WWU AS BOOKSTORE BELLINGHAM WA               04/21,-43.71,DEBIT_CARD,946.71,
DEBIT,4/22/2016,TACO TIME SAMISH BELLINGHAM WA               04/20,-5.97,DEBIT_CARD,990.42,
DEBIT,4/20/2016,RITE AID STORE - 5238 BELLINGHAM WA  154483  04/20,-18.06,DEBIT_CARD,996.39,
DEBIT,4/20/2016,ARAMARK ZOES BOOKSIDE B BELLINGHAM WA        04/19,-5.09,DEBIT_CARD,1014.45,
DEBIT,4/20/2016,ARAMARK TOPIOS BELLINGHAM WA                 04/18,-4.12,DEBIT_CARD,1019.54,
DEBIT,4/19/2016,ARAMARK ZOES BOOKSIDE B BELLINGHAM WA        04/18,-6.94,DEBIT_CARD,1023.66,
DEBIT,4/18/2016,ARAMARK ZOES BOOKSIDE B BELLINGHAM WA        04/17,-6.46,DEBIT_CARD,1030.6,
DEBIT,4/18/2016,ARAMARK MILLER MARKET P BELLINGHAM WA        04/15,-3.26,DEBIT_CARD,1037.06,
DEBIT,4/18/2016,WWU EMARKETS 360-650-3720 WA                 04/15,-33,DEBIT_CARD,1040.32,
DEBIT,4/18/2016,ARAMARK ZOES BOOKSIDE B BELLINGHAM WA        04/14,-8.01,DEBIT_CARD,1073.32,
DEBIT,4/18/2016,WWU LIBRARY BELLINGHAM WA                    04/14,-2,DEBIT_CARD,1081.33,
DEBIT,4/15/2016,NON-CHASE ATM FEE-WITH,-2.5,FEE_TRANSACTION,1083.33,
DEBIT,4/15/2016,NON-CHASE ATM WITHDRAW               225011  04/15516 HIGH,-25,ATM,1085.83,
DEBIT,4/15/2016,ARAMARK TOPIOS BELLINGHAM WA                 04/13,-7.37,DEBIT_CARD,1110.83,
DEBIT,4/14/2016,ARAMARK ZOES BOOKSIDE B BELLINGHAM WA        04/13,-3.25,DEBIT_CARD,1118.2,
DEBIT,4/14/2016,ARAMARK TOPIOS BELLINGHAM WA                 04/12,-4.12,DEBIT_CARD,1121.45,
DEBIT,4/13/2016,APL* ITUNES.COM/BILL 866-712-7753 CA         04/13,-5.47,DEBIT_CARD,1125.57,
DEBIT,4/13/2016,ARAMARK MILLER MARKET P BELLINGHAM WA        04/11,-4.34,DEBIT_CARD,1131.04,
DEBIT,4/12/2016,PAYPAL           INST XFER  PHONE HALO      WEB ID: PAYPALSI77,-29,ACH_DEBIT,1135.38,
DEBIT,4/12/2016,INTUIT *QUICKEN 800-446-8848 CA              04/11,-32.87,DEBIT_CARD,1164.38,
DEBIT,4/12/2016,TACO TIME SAMISH BELLINGHAM WA               04/10,-5.97,DEBIT_CARD,1197.25,
CREDIT,4/12/2016,KEY CR. TRANSFER ONLINE BK  000000012087441 WEB ID: 9000000008,131.48,ACH_CREDIT,1203.22,
DEBIT,4/11/2016,FRED MEYER FRED MEYER BELLINGHAM WA  832022  04/10,-3.47,DEBIT_CARD,1071.74,
DEBIT,4/11/2016,FRED MEYER FRED MEYER BELLINGHAM WA  853981  04/10,-134.87,DEBIT_CARD,1075.21,
DEBIT,4/11/2016,FRED MEYER FRED MEYER BELLINGHAM WA  534039  04/09,-17.37,DEBIT_CARD,1210.08,
DEBIT,4/11/2016,ROCK AND RYE BELLINGHAM WA                   04/08,-27.5,DEBIT_CARD,1227.45,
DEBIT,4/8/2016,ARROW LOCK SERVICE BELLINGHAM WA             04/07,-54.35,DEBIT_CARD,1254.95,
DEBIT,4/8/2016,WILSON MOTORS BELLINGHAM WA                  04/07,-235.57,DEBIT_CARD,1309.3,
DEBIT,4/8/2016,WWU LIBRARY BELLINGHAM WA                    04/06,-2,DEBIT_CARD,1544.87,
DEBIT,4/7/2016,ARAMARK TOPIOS BELLINGHAM WA                 04/05,-7.59,DEBIT_CARD,1546.87,
DEBIT,4/7/2016,ARAMARK MILLER MARKET P BELLINGHAM WA        04/05,-6.62,DEBIT_CARD,1554.46,
DEBIT,4/6/2016,RITE AID STORE - 5238 BELLINGHAM WA  448137  04/06,-4.89,DEBIT_CARD,1561.08,
DEBIT,4/6/2016,TRANSFER TO SAV XXXXX9660 04/06,-25,ACCT_XFER,1565.97,
DEBIT,4/5/2016,ARAMARK ZOES BOOKSIDE B BELLINGHAM WA        04/04,-6.62,DEBIT_CARD,1590.97,
DEBIT,4/5/2016,TACO TIME SAMISH BELLINGHAM WA               04/03,-9.42,DEBIT_CARD,1597.59,
DEBIT,4/4/2016,PAYPAL           INST XFER  BLIZZARDENT     WEB ID: PAYPALSI77,-21.91,ACH_DEBIT,1607.01,
DEBIT,4/4/2016,76 00399196 BELLINGHAM WA                    04/03,-31.42,DEBIT_CARD,1628.92,
DEBIT,4/4/2016,CRUISIN COFFEE - CORDA BELLINGHAM WA         04/03,-8.56,DEBIT_CARD,1660.34,
DEBIT,4/4/2016,BOLTBUS - INTERNET PA 214-849-8966 OR        04/03,-32.5,DEBIT_CARD,1668.9,
DEBIT,4/4/2016,SUSHIYAMA VANCOUVER BC                       04/01 CA DOLLAR  15.13 X 0.7713153 (EXCHG RTE) + 0.35 (EXCHG RTE ADJ),-12.02,DEBIT_CARD,1701.4,
DEBIT,4/4/2016,ARAMARK ZOES BOOKSIDE B BELLINGHAM WA        04/01,-8.74,DEBIT_CARD,1713.42,
DEBIT,4/4/2016,ARAMARK STARBUCKS BELLINGHAM WA              03/31,-6.79,DEBIT_CARD,1722.16,
DEBIT,4/1/2016,Online Transfer to  SAV ...9660 transaction#: 5229823055,-50,ACCT_XFER,1728.95,
DEBIT,4/1/2016,SUPER DUPER BURGER & T BELLINGHAM WA         04/01,-13.19,DEBIT_CARD,1778.95,
DEBIT,4/1/2016,ARAMARK ATRIUM POD BELLINGHAM WA             03/30,-5.96,DEBIT_CARD,1792.14,
DEBIT,3/31/2016,NON-CHASE ATM FEE-WITH,-2.5,FEE_TRANSACTION,1798.1,
DEBIT,3/31/2016,NON-CHASE ATM WITHDRAW               520221  03/301715 N ST,-22.95,ATM,1800.6,
DEBIT,3/31/2016,SQ *REDLIGHT BELLINGHAM Bellingham WA        03/30,-10,DEBIT_CARD,1823.55,
DEBIT,3/31/2016,ON RICE THAI BISTRO BELLINGHAM WA            03/29,-22.09,DEBIT_CARD,1833.55,
DEBIT,3/31/2016,ARAMARK ROCKS EDGE CAFE BELLINGHAM WA        03/29,-5.42,DEBIT_CARD,1855.64,
DEBIT,3/31/2016,ARAMARK ROCKS EDGE CAFE BELLINGHAM WA        03/29,-5.53,DEBIT_CARD,1861.06,
CREDIT,3/31/2016,INTERNAL DRIVE.  DIRECT DEP                 PPD ID: 9111111101,151.46,ACH_CREDIT,1866.59,
DEBIT,3/29/2016,REGAL BARKLEY VILLAGE S BELLINGHAM WA        03/28,-11.91,DEBIT_CARD,1715.13,
DEBIT,3/29/2016,WWU EMARKETS 360-650-3720 WA                 03/28,-33,DEBIT_CARD,1727.04,
DEBIT,3/28/2016,PAYPAL           INST XFER  HAYLEYGG689     WEB ID: PAYPALSI77,-7,ACH_DEBIT,1760.04,
DEBIT,3/28/2016,PAYPAL           INST XFER  SLHOMEWORK      WEB ID: PAYPALSI77,-22.5,ACH_DEBIT,1767.04,
DEBIT,3/28/2016,PAYPAL           INST XFER  HAYLEYGG689     WEB ID: PAYPALSI77,-625,ACH_DEBIT,1789.54,
DEBIT,3/28/2016,Lovers Bellingham WA                 203641  03/28,-42.09,DEBIT_CARD,2414.54,
DEBIT,3/28/2016,FRED MEYER FRED MEYER BELLINGHAM WA  822579  03/27,-71.4,DEBIT_CARD,2456.63,
DEBIT,3/28/2016,REGAL BARKLEY VILLAGE S BELLINGHAM WA        03/27,-11.91,DEBIT_CARD,2528.03,
DEBIT,3/28/2016,MT BAKER SKI FOOD SERV BELLINGHAM WA         03/25,-13.5,DEBIT_CARD,2539.94,
DEBIT,3/28/2016,MT BAKER SKI AREA INC BELLINGHAM WA          03/25,-59.16,DEBIT_CARD,2553.44,
DEBIT,3/28/2016,SHOTS 2 GO BELLINGHAM WA                     03/25,-8.4,DEBIT_CARD,2612.6,
DEBIT,3/28/2016,DIN TAI FUNG RESTA SEATTLE WA                03/24,-27.39,DEBIT_CARD,2621,
DEBIT,3/25/2016,Online Transfer to SAV ...9660 transaction#: 5281852333 03/25,-321.43,ACCT_XFER,2648.39,
DEBIT,3/24/2016,REPUBLIC PARKING 30 64 SEATTLE WA            03/23,-17,DEBIT_CARD,2969.82,
DEBIT,3/24/2016,MEE SUM PASTRIES SEATTLE WA                  03/23,-6.75,DEBIT_CARD,2986.82,
DEBIT,3/24/2016,SEATTLE AQUARIUM TICKET SEATTLE WA           03/23,-22.95,DEBIT_CARD,2993.57,
DEBIT,3/23/2016,QUALITY FOOD CEN 2746 SEATTLE WA     622879  03/23,-8.93,DEBIT_CARD,3016.52,
DEBIT,3/23/2016,VEHICLE EMISSIONS 4 SEATTLE WA               03/22,-15,DEBIT_CARD,3025.45,
CREDIT,3/23/2016,KEY CR. TRANSFER ONLINE BK  000000011974591 WEB ID: 9000000008,1111.67,ACH_CREDIT,3040.45,
DEBIT,3/22/2016,CHEVRON/SALMON SERVICE SEATTLE WA    078048  03/22,-25,DEBIT_CARD,1928.78,
DEBIT,3/22/2016,PATXI'S PIZZA -BALLARD SEATTLE WA            03/21,-32.59,DEBIT_CARD,1953.78,
DEBIT,3/22/2016,SKILLET COUNTER SEATTLE WA                   03/20,-13.06,DEBIT_CARD,1986.37,
DEBIT,3/21/2016,NON-CHASE ATM FEE-WITH,-2.5,FEE_TRANSACTION,1999.43,
DEBIT,3/21/2016,PAYPAL           INST XFER  HAYLEYGG689     WEB ID: PAYPALSI77,-51.39,ACH_DEBIT,2001.93,
DEBIT,3/21/2016,NON-CHASE ATM WITHDRAW               254386  03/20111 NE 45,-22.5,ATM,2053.32,
DEBIT,3/21/2016,SQ *A JUKE JOINT PRODUC Seattle WA           03/21,-7.25,DEBIT_CARD,2075.82,
DEBIT,3/21/2016,PACIFIC SCIENCE CENTER SEATTLE WA            03/20,-15,DEBIT_CARD,2083.07,
DEBIT,3/18/2016,UBER TECHNOLOGIES INC 866-576-1039 CA        03/18,-20.82,DEBIT_CARD,2098.07,
DEBIT,3/18/2016,PCC - FREMONT #8 SEATTLE WA                  03/17,-14.25,DEBIT_CARD,2118.89,
DEBIT,3/18/2016,PCC-VIEW RIDGE #5 SEATTLE WA                 03/17,-3.43,DEBIT_CARD,2133.14,
